QuestionNo,StateAb,DivisionID,PollingPlaceNm,YesVotes,YesPercentage,NoVotes,NoPercentage,FormalVotes,FormalPercentage,InformalVotes,InformalPercentage,TotalVotes
1,WA,239,Acton Park,47,18.95,201,81.05,248,99.6,1,0.4,249
1,WA,243,Albany,637,39.86,961,60.14,1598,98.82,19,1.18,1617
1,WA,243,Albany PPVC,3761,26.58,10389,73.42,14150,99.24,109,0.76,14259
1,WA,237,Alexander Heights,564,39.06,880,60.94,1444,98.5,22,1.5,1466
1,WA,237,Alexander Heights West,366,37.5,610,62.5,976,99.09,9,0.91,985
1,WA,244,Alkimos,332,32.61,686,67.39,1018,99.61,4,0.39,1022
1,WA,244,Alkimos PPVC,1186,29,2903,71,4089,99.42,24,0.58,4113
1,WA,244,Alkimos West,600,37.08,1018,62.92,1618,98.78,20,1.22,1638
1,WA,243,Allanson,50,30.12,116,69.88,166,99.4,1,0.6,167
1,WA,248,Applecross,885,44.74,1093,55.26,1978,99.05,19,0.95,1997
1,WA,240,Applecross FREMANTLE PPVC,316,46.2,368,53.8,684,99.42,4,0.58,688
1,WA,247,Applecross SWAN PPVC,1336,39.84,2017,60.16,3353,99.64,12,0.36,3365
1,WA,248,Applecross TANGNEY PPVC,2028,34.6,3833,65.4,5861,99.64,21,0.36,5882
1,WA,248,Ardross,288,43.57,373,56.43,661,99.4,4,0.6,665
1,WA,248,Ardross West,437,45.62,521,54.38,958,99.27,7,0.73,965
1,WA,317,Armadale,563,36.77,968,63.23,1531,98.65,21,1.35,1552
1,WA,317,Armadale BURT PPVC,2167,25.27,6410,74.73,8577,99.29,61,0.71,8638
1,WA,236,Armadale CANNING PPVC,537,23.51,1747,76.49,2284,99.39,14,0.61,2298
1,WA,317,Armadale East (Burt),240,36.2,423,63.8,663,98.96,7,1.04,670
1,WA,236,Armadale East (Canning),209,28.4,527,71.6,736,99.33,5,0.67,741
1,WA,317,Armadale North,258,33.77,506,66.23,764,99.35,5,0.65,769
1,WA,317,Armadale South,81,31.76,174,68.24,255,99.61,1,0.39,256
1,WA,317,Armadale West,540,31.4,1180,68.6,1720,98.79,21,1.21,1741
1,WA,245,Ashfield,441,58.88,308,41.12,749,99.47,4,0.53,753
1,WA,248,Attadale,921,46.05,1079,53.95,2000,99.6,8,0.4,2008
1,WA,240,Atwell,785,38.9,1233,61.1,2018,99.07,19,0.93,2037
1,WA,240,Atwell Central,204,40.8,296,59.2,500,98.43,8,1.57,508
1,WA,240,Atwell South,529,43.65,683,56.35,1212,99.18,10,0.82,1222
1,WA,240,Aubin Grove,806,43.57,1044,56.43,1850,98.72,24,1.28,1874
1,WA,239,Augusta,277,30.64,627,69.36,904,98.91,10,1.09,914
1,WA,239,Australind,205,29.84,482,70.16,687,98.85,8,1.15,695
1,WA,239,Australind Central,135,27.22,361,72.78,496,98.8,6,1.2,502
1,WA,239,Australind East,163,30.47,372,69.53,535,98.53,8,1.47,543
1,WA,239,Australind North,219,28.55,548,71.45,767,99.35,5,0.65,772
1,WA,239,Australind PPVC,2184,20.85,8293,79.15,10477,99.24,80,0.76,10557
1,WA,239,Australind South,264,28.48,663,71.52,927,99.14,8,0.86,935
1,WA,305,Aveley,278,30.82,624,69.18,902,98.15,17,1.85,919
1,WA,305,Aveley East,764,39,1195,61,1959,99.44,11,0.56,1970
1,WA,312,Badgingarra,22,18.49,97,81.51,119,100,0,0,119
1,WA,312,Bakers Hill,73,18.62,319,81.38,392,99.75,1,0.25,393
1,WA,237,Balcatta,769,41.77,1072,58.23,1841,98.87,21,1.13,1862
1,WA,237,Balcatta Central,126,47.55,139,52.45,265,98.15,5,1.85,270
1,WA,237,Balcatta COWAN PPVC,2153,29.87,5056,70.13,7209,99.3,51,0.7,7260
1,WA,238,Balcatta CURTIN PPVC,814,38.41,1305,61.59,2119,99.62,8,0.38,2127
1,WA,242,Balcatta MOORE PPVC,569,28.39,1435,71.61,2004,99.36,13,0.64,2017
1,WA,237,Balcatta North,645,37.65,1068,62.35,1713,99.13,15,0.87,1728
1,WA,245,Balcatta PERTH PPVC,321,38.96,503,61.04,824,98.45,13,1.55,837
1,WA,237,Balcatta West,488,35.18,899,64.82,1387,98.93,15,1.07,1402
1,WA,235,Baldivis,694,33.8,1359,66.2,2053,99.18,17,0.82,2070
1,WA,235,Baldivis Central,700,33.44,1393,66.56,2093,99.05,20,0.95,2113
1,WA,235,Baldivis East,550,37.49,917,62.51,1467,98.92,16,1.08,1483
1,WA,235,Baldivis North,888,35.25,1631,64.75,2519,98.71,33,1.29,2552
1,WA,235,Baldivis South,465,34.5,883,65.5,1348,98.83,16,1.17,1364
1,WA,237,Balga,730,50.62,712,49.38,1442,98.43,23,1.57,1465
1,WA,237,Balga North,580,42.65,780,57.35,1360,98.98,14,1.02,1374
1,WA,239,Balingup,159,39.07,248,60.93,407,99.03,4,0.97,411
1,WA,237,Ballajura,401,38.56,639,61.44,1040,99.05,10,0.95,1050
1,WA,237,Ballajura Central,554,37.26,933,62.74,1487,98.54,22,1.46,1509
1,WA,237,Ballajura South,605,38.71,958,61.29,1563,98.61,22,1.39,1585
1,WA,237,Ballajura West,632,37.64,1047,62.36,1679,99.06,16,0.94,1695
1,WA,244,Banksia Grove,462,34.82,865,65.18,1327,97.93,28,2.07,1355
1,WA,244,Banksia Grove North,730,39.98,1096,60.02,1826,99.02,18,0.98,1844
1,WA,245,Bassendean,598,51.11,572,48.89,1170,98.98,12,1.02,1182
1,WA,245,Bassendean South,1036,58.33,740,41.67,1776,99.11,16,0.89,1792
1,WA,248,Bateman,543,48.79,570,51.21,1113,99.02,11,0.98,1124
1,WA,248,Bateman South,253,50,253,50,506,99.22,4,0.78,510
1,WA,243,Bayonet Head,257,29.61,611,70.39,868,98.41,14,1.59,882
1,WA,245,Bayswater,1148,65.45,606,34.55,1754,98.98,18,1.02,1772
1,WA,245,Bayswater North,1291,58.6,912,41.4,2203,98.88,25,1.12,2228
1,WA,245,Bayswater PPVC,2698,47.48,2984,52.52,5682,99.37,36,0.63,5718
1,WA,240,Beaconsfield,872,70.27,369,29.73,1241,98.57,18,1.43,1259
1,WA,240,Beaconsfield South,864,60.93,554,39.07,1418,98.47,22,1.53,1440
1,WA,317,Beckenham,560,40.37,827,59.63,1387,99.21,11,0.79,1398
1,WA,317,Beckenham BURT PPVC,1071,29.01,2621,70.99,3692,99.35,24,0.65,3716
1,WA,247,Beckenham SWAN PPVC,1045,32.16,2204,67.84,3249,99.42,19,0.58,3268
1,WA,248,Beckenham TANGNEY PPVC,340,34.45,647,65.55,987,99.2,8,0.8,995
1,WA,245,Bedford,537,53.38,469,46.62,1006,98.92,11,1.08,1017
1,WA,236,Bedfordale,145,24.7,442,75.3,587,98.99,6,1.01,593
1,WA,237,Beechboro,405,38.53,646,61.47,1051,98.59,15,1.41,1066
1,WA,237,Beechboro East (Cowan),370,33.58,732,66.42,1102,98.57,16,1.43,1118
1,WA,305,Beechboro East (Hasluck),175,38.89,275,61.11,450,98.04,9,1.96,459
1,WA,237,Beechboro West,266,41.37,377,58.63,643,98.62,9,1.38,652
1,WA,240,Beeliar,748,44.63,928,55.37,1676,98.65,23,1.35,1699
1,WA,240,Beeliar West,623,35.28,1143,64.72,1766,98.66,24,1.34,1790
1,WA,242,Beldon,613,40.01,919,59.99,1532,98.58,22,1.42,1554
1,WA,305,Bellevue,310,38.7,491,61.3,801,99.5,4,0.5,805
1,WA,247,Belmont,454,45.86,536,54.14,990,98.21,18,1.79,1008
1,WA,247,Belmont East,732,45.78,867,54.22,1599,98.58,23,1.42,1622
1,WA,245,Belmont PERTH PPVC,422,44.42,528,55.58,950,99.06,9,0.94,959
1,WA,247,Belmont South,697,44.79,859,55.21,1556,98.79,19,1.21,1575
1,WA,247,Belmont SWAN PPVC,4034,36.05,7156,63.95,11190,99.22,88,0.78,11278
1,WA,243,Bencubbin,20,18.02,91,81.98,111,99.11,1,0.89,112
1,WA,247,Bentley,386,58.48,274,41.52,660,99.7,2,0.3,662
1,WA,247,Bentley PPVC,2162,43.6,2797,56.4,4959,99.42,29,0.58,4988
1,WA,247,Bentley South,509,52.31,464,47.69,973,99.18,8,0.82,981
1,WA,235,Bertram,678,38.57,1080,61.43,1758,98.76,22,1.24,1780
1,WA,243,Beverley,149,20.61,574,79.39,723,99.59,3,0.41,726
1,WA,240,Bibra Lake,798,46.56,916,53.44,1714,99.25,13,0.75,1727
1,WA,248,Bicton,905,54.62,752,45.38,1657,99.04,16,0.96,1673
1,WA,248,Bicton North,277,52.56,250,47.44,527,98.69,7,1.31,534
1,WA,312,Bilingurr,245,53.38,214,46.62,459,99.57,2,0.43,461
1,WA,312,Bindoon,185,18.41,820,81.59,1005,99.7,3,0.3,1008
1,WA,239,Binningup,140,28.46,352,71.54,492,98.4,8,1.6,500
1,WA,312,Bluff Point,331,32.58,685,67.42,1016,98.35,17,1.65,1033
1,WA,312,Bluff Point South,117,30.55,266,69.45,383,98.97,4,1.03,387
1,WA,243,Boddington,109,17.17,526,82.83,635,98.6,9,1.4,644
1,WA,248,Booragoon,897,51.32,851,48.68,1748,99.21,14,0.79,1762
1,WA,243,Boulder,246,20.25,969,79.75,1215,99.35,8,0.65,1223
1,WA,239,Boyanup,183,22.54,629,77.46,812,99.02,8,0.98,820
1,WA,243,Boyup Brook,120,15.75,642,84.25,762,99.48,4,0.52,766
1,WA,305,Brabham,1041,43,1380,57,2421,99.3,17,0.7,2438
1,WA,243,Bremer Bay,54,17.03,263,82.97,317,98.75,4,1.25,321
1,WA,248,Brentwood,897,51.79,835,48.21,1732,99.2,14,0.8,1746
1,WA,243,Bridgetown,534,34.17,1029,65.83,1563,98.92,17,1.08,1580
1,WA,317,Brookdale,489,35.1,904,64.9,1393,99.08,13,0.92,1406
1,WA,243,Brookton,55,13.55,351,86.45,406,99.51,2,0.49,408
1,WA,312,Broome,541,56.24,421,43.76,962,98.77,12,1.23,974
1,WA,312,Broome PPVC,2092,50.24,2072,49.76,4164,99.28,30,0.72,4194
1,WA,243,Broomehill,37,17.37,176,82.63,213,97.71,5,2.29,218
1,WA,243,Bruce Rock,80,20.73,306,79.27,386,99.48,2,0.52,388
1,WA,239,Brunswick,105,17.89,482,82.11,587,98.99,6,1.01,593
1,WA,248,Bull Creek,611,45.8,723,54.2,1334,99.18,11,0.82,1345
1,WA,248,Bull Creek East,481,47.3,536,52.7,1017,99.12,9,0.88,1026
1,WA,312,Bullsbrook,500,20.97,1884,79.03,2384,98.96,25,1.04,2409
1,WA,239,Bunbury,604,46.11,706,53.89,1310,98.72,17,1.28,1327
1,WA,239,Bunbury Central,399,36.74,687,63.26,1086,98.55,16,1.45,1102
1,WA,239,Bunbury East,337,34.46,641,65.54,978,98.39,16,1.61,994
1,WA,239,Bunbury PPVC,3726,24.45,11512,75.55,15238,99.34,101,0.66,15339
1,WA,239,Bunbury South,475,38.15,770,61.85,1245,99.2,10,0.8,1255
1,WA,239,Burekup,114,26.33,319,73.67,433,98.63,6,1.37,439
1,WA,242,Burns Beach,788,35.12,1456,64.88,2244,99.16,19,0.84,2263
1,WA,239,Busselton,301,40.9,435,59.1,736,98.92,8,1.08,744
1,WA,239,Busselton East,377,33.69,742,66.31,1119,98.59,16,1.41,1135
1,WA,239,Busselton PPVC,2893,26.64,7966,73.36,10859,99.23,84,0.77,10943
1,WA,239,Busselton South,703,34.63,1327,65.37,2030,98.35,34,1.65,2064
1,WA,239,Busselton West,486,35.37,888,64.63,1374,99.06,13,0.94,1387
1,WA,244,Butler,527,32.45,1097,67.55,1624,99.57,7,0.43,1631
1,WA,244,Butler East,466,37.07,791,62.93,1257,99.13,11,0.87,1268
1,WA,244,Butler North,402,38.92,631,61.08,1033,99.04,10,0.96,1043
1,WA,244,Butler South,171,39.86,258,60.14,429,99.31,3,0.69,432
1,WA,236,Byford,513,27.96,1322,72.04,1835,99.4,11,0.6,1846
1,WA,236,Byford North,339,28.97,831,71.03,1170,99.07,11,0.93,1181
1,WA,236,Byford PPVC,1422,19.87,5734,80.13,7156,99.29,51,0.71,7207
1,WA,236,Byford West,716,31.82,1534,68.18,2250,98.9,25,1.1,2275
1,WA,312,Cable Beach,303,61.21,192,38.79,495,99,5,1,500
1,WA,312,Calingiri,14,8.59,149,91.41,163,99.39,1,0.61,164
1,WA,235,Calista,514,38.94,806,61.06,1320,98.58,19,1.42,1339
1,WA,317,Camillo,330,32.67,680,67.33,1010,98.44,16,1.56,1026
1,WA,317,Camillo South,497,35.45,905,64.55,1402,98.59,20,1.41,1422
1,WA,248,Canning Vale,938,38.11,1523,61.89,2461,98.8,30,1.2,2491
1,WA,248,Canning Vale East,327,36.29,574,63.71,901,98.69,12,1.31,913
1,WA,248,Canning Vale North,880,43.39,1148,56.61,2028,99.12,18,0.88,2046
1,WA,248,Canning Vale South,639,37.97,1044,62.03,1683,99.29,12,0.71,1695
1,WA,248,Canning Vale West,836,39.79,1265,60.21,2101,99.01,21,0.99,2122
1,WA,312,Cape Burney,52,26.8,142,73.2,194,98.98,2,1.02,196
1,WA,239,Capel,424,26.37,1184,73.63,1608,99.5,8,0.5,1616
1,WA,239,Carbunup River,113,37.17,191,62.83,304,99.35,2,0.65,306
1,WA,239,Carey Park,398,32.1,842,67.9,1240,98.73,16,1.27,1256
1,WA,239,Carey Park South,196,28.12,501,71.88,697,98.17,13,1.83,710
1,WA,242,Carine,588,45.9,693,54.1,1281,99.15,11,0.85,1292
1,WA,242,Carine North,393,57.79,287,42.21,680,99.27,5,0.73,685
1,WA,247,Carlisle,563,54.98,461,45.02,1024,98.56,15,1.44,1039
1,WA,312,Carnamah,24,11.48,185,88.52,209,99.52,1,0.48,210
1,WA,312,Carnarvon,164,32.16,346,67.84,510,99.42,3,0.58,513
1,WA,312,Carnarvon PPVC,369,23.52,1200,76.48,1569,99.68,5,0.32,1574
1,WA,244,Carramar,646,31.96,1375,68.04,2021,99.21,16,0.79,2037
1,WA,243,Castletown,200,21.1,748,78.9,948,99.06,9,0.94,957
1,WA,305,Caversham,789,40.34,1167,59.66,1956,98.89,22,1.11,1978
1,WA,243,Centennial Park,183,34.01,355,65.99,538,99.45,3,0.55,541
1,WA,312,Cervantes,25,9.62,235,90.38,260,98.48,4,1.52,264
1,WA,305,Chidlow,208,29.34,501,70.66,709,98.88,8,1.12,717
1,WA,238,Churchlands,742,52.85,662,47.15,1404,99.36,9,0.64,1413
1,WA,238,Churchlands North,245,51.91,227,48.09,472,99.58,2,0.42,474
1,WA,238,City Beach,639,50.31,631,49.69,1270,99.06,12,0.94,1282
1,WA,238,City Beach North,670,51.46,632,48.54,1302,98.94,14,1.06,1316
1,WA,238,Claremont,1078,50.97,1037,49.03,2115,99.25,16,0.75,2131
1,WA,244,Clarkson,340,41.67,476,58.33,816,98.67,11,1.33,827
1,WA,242,Clarkson MOORE PPVC,326,29.11,794,70.89,1120,99.2,9,0.8,1129
1,WA,244,Clarkson PEARCE PPVC,3346,27.11,8997,72.89,12343,99.21,98,0.79,12441
1,WA,244,Clarkson South,593,40.31,878,59.69,1471,99.12,13,0.88,1484
1,WA,244,Clarkson West,234,33.14,472,66.86,706,97.78,16,2.22,722
1,WA,239,Clifton Park,120,34.88,224,65.12,344,99.42,2,0.58,346
1,WA,247,Cloverdale,288,43.37,376,56.63,664,99.25,5,0.75,669
1,WA,235,Cockburn Central BRAND PPVC,271,30.25,625,69.75,896,98.79,11,1.21,907
1,WA,317,Cockburn Central BURT PPVC,714,33.57,1413,66.43,2127,99.58,9,0.42,2136
1,WA,240,Cockburn Central FREMANTLE PPVC,2389,32.4,4984,67.6,7373,99.23,57,0.77,7430
1,WA,240,Cockburn Central North FREMANTLE PPVC,1211,31.25,2664,68.75,3875,99.46,21,0.54,3896
1,WA,248,Cockburn Central North TANGNEY PPVC,92,31.19,203,68.81,295,100,0,0,295
1,WA,243,Collie,182,21.72,656,78.28,838,99.17,7,0.83,845
1,WA,243,Collie North,49,22.58,168,77.42,217,99.09,2,0.91,219
1,WA,243,Collie PPVC,682,17.36,3247,82.64,3929,99.37,25,0.63,3954
1,WA,243,Collie South,47,25.27,139,74.73,186,99.47,1,0.53,187
1,WA,247,Como,1045,51.84,971,48.16,2016,99.26,15,0.74,2031
1,WA,247,Como East,720,53.89,616,46.11,1336,99.26,10,0.74,1346
1,WA,247,Como South,452,49.78,456,50.22,908,98.59,13,1.41,921
1,WA,243,Condingup,14,15.73,75,84.27,89,98.89,1,1.11,90
1,WA,242,Connolly,524,37.4,877,62.6,1401,99.29,10,0.71,1411
1,WA,236,Coodanup,255,29.01,624,70.99,879,98.43,14,1.57,893
1,WA,240,Coogee,673,39.73,1021,60.27,1694,98.43,27,1.57,1721
1,WA,240,Coolbellup,908,53.82,779,46.18,1687,98.77,21,1.23,1708
1,WA,245,Coolbinia,867,51.76,808,48.24,1675,99.05,16,0.95,1691
1,WA,243,Coolgardie,72,25.26,213,74.74,285,100,0,0,285
1,WA,235,Cooloongup,277,27.24,740,72.76,1017,99.03,10,0.97,1027
1,WA,235,Cooloongup South,213,33.18,429,66.82,642,98.17,12,1.83,654
1,WA,236,Coolup,57,13.32,371,86.68,428,99.53,2,0.47,430
1,WA,312,Coorow,14,11.86,104,88.14,118,100,0,0,118
1,WA,312,Coral Bay,36,45,44,55,80,97.56,2,2.44,82
1,WA,243,Corrigin,94,18.11,425,81.89,519,98.86,6,1.14,525
1,WA,238,Cottesloe,912,53.08,806,46.92,1718,99.42,10,0.58,1728
1,WA,238,Cottesloe North,866,56.12,677,43.88,1543,98.91,17,1.09,1560
1,WA,239,Cowaramup,498,50.61,486,49.39,984,99.09,9,0.91,993
1,WA,242,Craigie,762,42.64,1025,57.36,1787,98.84,21,1.16,1808
1,WA,243,Cranbrook,37,10.72,308,89.28,345,99.14,3,0.86,348
1,WA,243,Cuballing,52,19.62,213,80.38,265,98.88,3,1.12,268
1,WA,312,Cue,17,18.48,75,81.52,92,100,0,0,92
1,WA,243,Cunderdin,57,15,323,85,380,99.48,2,0.52,382
1,WA,242,Currambine,619,36.01,1100,63.99,1719,98.85,20,1.15,1739
1,WA,242,Currambine MOORE PPVC,2395,27.51,6312,72.49,8707,99.38,54,0.62,8761
1,WA,244,Currambine PEARCE PPVC,238,27.74,620,72.26,858,99.19,7,0.81,865
1,WA,242,Currambine West,164,31.91,350,68.09,514,98.47,8,1.53,522
1,WA,238,Dalkeith,857,44.8,1056,55.2,1913,99.53,9,0.47,1922
1,WA,312,Dalwallinu,81,21.77,291,78.23,372,99.73,1,0.27,373
1,WA,239,Dalyellup,675,31.78,1449,68.22,2124,98.65,29,1.35,2153
1,WA,239,Dalyellup South,357,31.12,790,68.88,1147,98.45,18,1.55,1165
1,WA,312,Dampier PPVC,586,26.09,1660,73.91,2246,99.34,15,0.66,2261
1,WA,312,Dandaragan,46,18.4,204,81.6,250,100,0,0,250
1,WA,244,Darch,699,37.99,1141,62.01,1840,98.71,24,1.29,1864
1,WA,244,Darch South,135,38.79,213,61.21,348,99.43,2,0.57,350
1,WA,239,Dardanup,167,20,668,80,835,99.52,4,0.48,839
1,WA,243,Darkan,23,11.98,169,88.02,192,98.97,2,1.03,194
1,WA,305,Darlington,789,59.32,541,40.68,1330,99.25,10,0.75,1340
1,WA,236,Dawesville,175,26.32,490,73.68,665,98.66,9,1.34,674
1,WA,236,Dawesville West,276,29.65,655,70.35,931,98.94,10,1.06,941
1,WA,305,Dayton,469,45.71,557,54.29,1026,99.52,5,0.48,1031
1,WA,312,Denham,138,36.9,236,63.1,374,98.94,4,1.06,378
1,WA,243,Denmark,1091,54.04,928,45.96,2019,99.02,20,0.98,2039
1,WA,312,Derby,378,49.03,393,50.97,771,99.1,7,0.9,778
1,WA,245,Dianella,588,46.05,689,53.95,1277,99.07,12,0.93,1289
1,WA,245,Dianella East,437,50.64,426,49.36,863,98.63,12,1.37,875
1,WA,237,Dianella Heights,501,42.82,669,57.18,1170,99.83,2,0.17,1172
1,WA,237,Dianella North,588,39.73,892,60.27,1480,99.26,11,0.74,1491
1,WA,245,Dianella South,454,52.91,404,47.09,858,98.28,15,1.72,873
1,WA,237,Dianella St Andrew's,326,30.27,751,69.73,1077,98.81,13,1.19,1090
1,WA,237,Dianella West,566,42.78,757,57.22,1323,98.95,14,1.05,1337
1,WA,312,Dongara,264,16.86,1302,83.14,1566,99.05,15,0.95,1581
1,WA,239,Donnybrook,430,24.23,1345,75.77,1775,98.94,19,1.06,1794
1,WA,238,Doubleview,1584,59.62,1073,40.38,2657,98.77,33,1.23,2690
1,WA,238,Doubleview North,204,61.26,129,38.74,333,98.81,4,1.19,337
1,WA,312,Dowerin,33,12.69,227,87.31,260,100,0,0,260
1,WA,312,Drummond Cove,175,32.41,365,67.59,540,98.72,7,1.28,547
1,WA,236,Dudley Park,270,28.75,669,71.25,939,98.74,12,1.26,951
1,WA,243,Dumbleyung,23,12.71,158,87.29,181,100,0,0,181
1,WA,242,Duncraig,775,49.05,805,50.95,1580,98.87,18,1.13,1598
1,WA,242,Duncraig East,600,48.78,630,51.22,1230,98.95,13,1.05,1243
1,WA,242,Duncraig North,739,48.27,792,51.73,1531,98.84,18,1.16,1549
1,WA,242,Duncraig PPVC,4116,33.81,8058,66.19,12174,99.55,55,0.45,12229
1,WA,242,Duncraig South,560,46.09,655,53.91,1215,99.18,10,0.82,1225
1,WA,239,Dunsborough,774,45.32,934,54.68,1708,98.61,24,1.39,1732
1,WA,239,Dunsborough South,477,55.08,389,44.92,866,98.86,10,1.14,876
1,WA,243,Duranillin,6,6.9,81,93.1,87,97.75,2,2.25,89
1,WA,236,Dwellingup,79,25,237,75,316,98.75,4,1.25,320
1,WA,239,Eagle Bay PPVC,465,43.79,597,56.21,1062,99.44,6,0.56,1068
1,WA,247,East Cannington,875,43.95,1116,56.05,1991,99.01,20,0.99,2011
1,WA,240,East Fremantle North,833,63.83,472,36.17,1305,98.94,14,1.06,1319
1,WA,245,East Perth,837,54.21,707,45.79,1544,99.1,14,0.9,1558
1,WA,247,East Victoria Park,1041,61.49,652,38.51,1693,99.3,12,0.7,1705
1,WA,247,East Victoria Park South,1182,63.93,667,36.07,1849,99.41,11,0.59,1860
1,WA,239,Eaton,195,25.76,562,74.24,757,98.95,8,1.05,765
1,WA,239,Eaton East,332,26.16,937,73.84,1269,98.75,16,1.25,1285
1,WA,239,Eaton North,238,28.92,585,71.08,823,99.04,8,0.96,831
1,WA,235,EAV Brand PPVC,0,0,0,0,0,0,0,0,0
1,WA,317,EAV Burt PPVC,0,0,0,0,0,0,0,0,0
1,WA,236,EAV Canning PPVC,0,0,0,0,0,0,0,0,0
1,WA,237,EAV Cowan PPVC,0,0,0,0,0,0,0,0,0
1,WA,238,EAV Curtin PPVC,0,0,0,0,0,0,0,0,0
1,WA,312,EAV Durack PPVC,0,0,0,0,0,0,0,0,0
1,WA,239,EAV Forrest PPVC,0,0,0,0,0,0,0,0,0
1,WA,240,EAV Fremantle PPVC,0,0,0,0,0,0,0,0,0
1,WA,305,EAV Hasluck PPVC,0,0,0,0,0,0,0,0,0
1,WA,242,EAV Moore PPVC,0,0,0,0,0,0,0,0,0
1,WA,243,EAV O'Connor PPVC,0,0,0,0,0,0,0,0,0
1,WA,244,EAV Pearce PPVC,0,0,0,0,0,0,0,0,0
1,WA,245,EAV Perth PPVC,0,0,0,0,0,0,0,0,0
1,WA,247,EAV Swan PPVC,0,0,0,0,0,0,0,0,0
1,WA,248,EAV Tangney PPVC,0,0,0,0,0,0,0,0,0
1,WA,245,Eden Hill,748,48.51,794,51.49,1542,99.04,15,0.96,1557
1,WA,242,Edgewater,722,43.47,939,56.53,1661,98.93,18,1.07,1679
1,WA,243,Elleker,107,31.75,230,68.25,337,99.12,3,0.88,340
1,WA,305,Ellenbrook,361,38.65,573,61.35,934,99.15,8,0.85,942
1,WA,305,Ellenbrook Central,565,38.65,897,61.35,1462,98.85,17,1.15,1479
1,WA,312,Ellenbrook DURACK PPVC,158,16.41,805,83.59,963,99.59,4,0.41,967
1,WA,305,Ellenbrook East,386,32.3,809,67.7,1195,99.17,10,0.83,1205
1,WA,305,Ellenbrook HASLUCK PPVC,3094,26.5,8582,73.5,11676,99.45,64,0.55,11740
1,WA,305,Ellenbrook North,549,37.3,923,62.7,1472,99.39,9,0.61,1481
1,WA,305,Ellenbrook South,413,34.71,777,65.29,1190,98.43,19,1.57,1209
1,WA,305,Ellenbrook West,517,34.81,968,65.19,1485,99.13,13,0.87,1498
1,WA,245,Embleton,514,47.46,569,52.54,1083,98.1,21,1.9,1104
1,WA,243,Emu Point,88,34.38,168,65.63,256,99.22,2,0.78,258
1,WA,312,Eneabba,18,15.52,98,84.48,116,99.15,1,0.85,117
1,WA,243,Esperance,304,32.58,629,67.42,933,99.47,5,0.53,938
1,WA,243,Esperance PPVC,793,17.4,3764,82.6,4557,99.37,29,0.63,4586
1,WA,312,Exmouth,397,35.01,737,64.99,1134,99.13,10,0.87,1144
1,WA,312,Exmouth PPVC,0,0,0,0,0,0,0,0,0
1,WA,236,Falcon PPVC,2274,21.16,8474,78.84,10748,99.46,58,0.54,10806
1,WA,239,Ferguson,58,35.8,104,64.2,162,98.18,3,1.82,165
1,WA,248,Ferndale,224,41.03,322,58.97,546,99.27,4,0.73,550
1,WA,248,Ferndale East,259,37.27,436,62.73,695,99,7,1,702
1,WA,312,Fitzroy Crossing,86,60.14,57,39.86,143,100,0,0,143
1,WA,312,Fitzroy Crossing PPVC,138,80.23,34,19.77,172,100,0,0,172
1,WA,238,Floreat,853,53.92,729,46.08,1582,99.56,7,0.44,1589
1,WA,238,Floreat East,472,54.95,387,45.05,859,98.96,9,1.04,868
1,WA,317,Forrestdale,163,29.16,396,70.84,559,98.42,9,1.58,568
1,WA,247,Forrestfield,597,31.34,1308,68.66,1905,99.06,18,0.94,1923
1,WA,247,Forrestfield North,625,32.17,1318,67.83,1943,98.68,26,1.32,1969
1,WA,247,Forrestfield West,277,37.69,458,62.31,735,98.39,12,1.61,747
1,WA,243,Frankland,38,19.59,156,80.41,194,99.49,1,0.51,195
1,WA,238,Fremantle CURTIN PPVC,675,54.66,560,45.34,1235,99.76,3,0.24,1238
1,WA,240,Fremantle East,1391,75.03,463,24.97,1854,99.2,15,0.8,1869
1,WA,240,Fremantle FREMANTLE PPVC,5376,60.66,3486,39.34,8862,99.24,68,0.76,8930
1,WA,240,Fremantle South,1316,76.51,404,23.49,1720,99.19,14,0.81,1734
1,WA,248,Fremantle TANGNEY PPVC,594,50.6,580,49.4,1174,98.99,12,1.01,1186
1,WA,236,Furnissdale,98,18.32,437,81.68,535,99.07,5,0.93,540
1,WA,312,Geraldton,507,35.45,923,64.55,1430,98.42,23,1.58,1453
1,WA,312,Geraldton PPVC,2789,20.18,11029,79.82,13818,99.44,78,0.56,13896
1,WA,243,Gibson,8,12.5,56,87.5,64,96.97,2,3.03,66
1,WA,305,Gidgegannup,268,28.51,672,71.49,940,98.95,10,1.05,950
1,WA,312,Gingin,133,16.12,692,83.88,825,99.52,4,0.48,829
1,WA,237,Girrawheen,552,40.98,795,59.02,1347,97.89,29,2.11,1376
1,WA,237,Girrawheen East,318,43.5,413,56.5,731,99.46,4,0.54,735
1,WA,305,Glen Forrest,478,51.68,447,48.32,925,99.25,7,0.75,932
1,WA,239,Glen Iris,212,26.3,594,73.7,806,99.26,6,0.74,812
1,WA,243,Gnowangerup,65,23.9,207,76.1,272,100,0,0,272
1,WA,235,Golden Bay,423,34.87,790,65.13,1213,98.54,18,1.46,1231
1,WA,312,Goomalling,40,12.58,278,87.42,318,99.38,2,0.63,320
1,WA,305,Gooseberry Hill,387,52.16,355,47.84,742,99.33,5,0.67,747
1,WA,317,Gosnells,519,36.22,914,63.78,1433,98.69,19,1.31,1452
1,WA,317,Gosnells Central,289,38.9,454,61.1,743,98.8,9,1.2,752
1,WA,317,Gosnells PPVC,1390,28.37,3509,71.63,4899,99.17,41,0.83,4940
1,WA,317,Gosnells South,550,34.18,1059,65.82,1609,98.89,18,1.11,1627
1,WA,317,Gosnells West,534,36.35,935,63.65,1469,98.79,18,1.21,1487
1,WA,243,Greenbushes,122,33.15,246,66.85,368,98.66,5,1.34,373
1,WA,236,Greenfields,666,28.2,1696,71.8,2362,98.62,33,1.38,2395
1,WA,236,Greenfields East,168,27.59,441,72.41,609,98.7,8,1.3,617
1,WA,236,Greenfields PPVC,4058,18.35,18056,81.65,22114,99.43,126,0.57,22240
1,WA,312,Greenhills,20,15.15,112,84.85,132,100,0,0,132
1,WA,305,Greenmount,421,39.64,641,60.36,1062,98.88,12,1.12,1074
1,WA,237,Greenwood,700,42.84,934,57.16,1634,99.15,14,0.85,1648
1,WA,237,Greenwood East,678,46.79,771,53.21,1449,99.11,13,0.89,1462
1,WA,305,Guildford,517,52.81,462,47.19,979,99.49,5,0.51,984
1,WA,238,Gwelup (Curtin),452,47.88,492,52.12,944,99.26,7,0.74,951
1,WA,242,Gwelup (Moore),416,43.56,539,56.44,955,99.17,8,0.83,963
1,WA,312,Halls Creek,128,52.24,117,47.76,245,99.19,2,0.81,247
1,WA,236,Halls Head,466,31.3,1023,68.7,1489,99,15,1,1504
1,WA,236,Halls Head North,500,27.61,1311,72.39,1811,98.96,19,1.04,1830
1,WA,236,Halls Head South,288,30.54,655,69.46,943,98.43,15,1.57,958
1,WA,237,Hamersley,606,45.84,716,54.16,1322,98.66,18,1.34,1340
1,WA,237,Hamersley East,338,48.56,358,51.44,696,98.72,9,1.28,705
1,WA,240,Hamilton Hill East,765,64.45,422,35.55,1187,99,12,1,1199
1,WA,240,Hamilton Hill South,943,51.78,878,48.22,1821,98.91,20,1.09,1841
1,WA,240,Hammond Park,901,45.12,1096,54.88,1997,98.71,26,1.29,2023
1,WA,243,Hannans,168,29.32,405,70.68,573,99.48,3,0.52,576
1,WA,317,Harrisdale,914,43.96,1165,56.04,2079,99.43,12,0.57,2091
1,WA,317,Harrisdale North,477,40.46,702,59.54,1179,99.49,6,0.51,1185
1,WA,243,Harrismith,14,21.88,50,78.13,64,98.46,1,1.54,65
1,WA,239,Harvey,352,19.69,1436,80.31,1788,99.17,15,0.83,1803
1,WA,305,Hazelmere,601,42.9,800,57.1,1401,98.87,16,1.13,1417
1,WA,242,Heathridge,561,37.47,936,62.53,1497,98.49,23,1.51,1520
1,WA,242,Heathridge East,413,39.04,645,60.96,1058,98.97,11,1.03,1069
1,WA,305,Helena Valley,558,36.9,954,63.1,1512,98.89,17,1.11,1529
1,WA,305,Herne Hill,164,22.87,553,77.13,717,98.22,13,1.78,730
1,WA,247,High Wycombe,554,29.01,1356,70.99,1910,98.86,22,1.14,1932
1,WA,247,High Wycombe North,178,29.18,432,70.82,610,99.35,4,0.65,614
1,WA,247,High Wycombe South,477,30.62,1081,69.38,1558,99.11,14,0.89,1572
1,WA,245,Highgate,1229,67.75,585,32.25,1814,99.45,10,0.55,1824
1,WA,245,Highgate North,360,67.42,174,32.58,534,99.44,3,0.56,537
1,WA,242,Hillarys,701,39.07,1093,60.93,1794,99.17,15,0.83,1809
1,WA,242,Hillarys North,530,42.88,706,57.12,1236,99.2,10,0.8,1246
1,WA,242,Hillarys West,463,41.23,660,58.77,1123,98.68,15,1.32,1138
1,WA,235,Hillman,256,33.12,517,66.88,773,98.35,13,1.65,786
1,WA,240,Hilton,1186,73.07,437,26.93,1623,99.02,16,0.98,1639
1,WA,244,Hocking,660,32.66,1361,67.34,2021,98.97,21,1.03,2042
1,WA,243,Hopetoun,105,21.56,382,78.44,487,99.59,2,0.41,489
1,WA,317,Huntingdale,691,33.74,1357,66.26,2048,99.18,17,0.82,2065
1,WA,243,Hyden,26,11.61,198,88.39,224,98.68,3,1.32,227
1,WA,245,Inglewood,652,63.06,382,36.94,1034,98.57,15,1.43,1049
1,WA,245,Inglewood North,1755,66.1,900,33.9,2655,99.03,26,0.97,2681
1,WA,238,Innaloo,967,53.04,856,46.96,1823,98.86,21,1.14,1844
1,WA,238,Innaloo South,389,56.38,301,43.62,690,99.71,2,0.29,692
1,WA,236,Jarrahdale,121,34.77,227,65.23,348,99.15,3,0.85,351
1,WA,243,Jerramungup,28,15.3,155,84.7,183,99.46,1,0.54,184
1,WA,238,Jolimont,819,60.98,524,39.02,1343,98.9,15,1.1,1358
1,WA,242,Joondalup,610,38.39,979,61.61,1589,99.13,14,0.87,1603
1,WA,242,Joondalup Central,413,46.83,469,53.17,882,99.44,5,0.56,887
1,WA,242,Joondalup MOORE PPVC,1593,33.91,3105,66.09,4698,99.41,28,0.59,4726
1,WA,244,Joondalup PEARCE PPVC,484,29.58,1152,70.42,1636,98.73,21,1.27,1657
1,WA,245,Joondanna,815,56.56,626,43.44,1441,99.24,11,0.76,1452
1,WA,312,Jurien Bay,150,14.93,855,85.07,1005,99.41,6,0.59,1011
1,WA,305,Kalamunda,284,48.3,304,51.7,588,99.66,2,0.34,590
1,WA,305,Kalamunda HASLUCK PPVC,2135,34.38,4075,65.62,6210,99.49,32,0.51,6242
1,WA,305,Kalamunda North,524,44.07,665,55.93,1189,98.84,14,1.16,1203
1,WA,247,Kalamunda SWAN PPVC,680,22.43,2351,77.57,3031,99.64,11,0.36,3042
1,WA,312,Kalbarri,149,23.58,483,76.42,632,98.9,7,1.1,639
1,WA,243,Kalgan,170,37.69,281,62.31,451,99.12,4,0.88,455
1,WA,243,Kalgoorlie,349,27.29,930,72.71,1279,98.84,15,1.16,1294
1,WA,243,Kalgoorlie North,255,26.84,695,73.16,950,99.79,2,0.21,952
1,WA,243,Kalgoorlie PPVC,1319,19.28,5521,80.72,6840,99.46,37,0.54,6877
1,WA,243,Kalgoorlie South,68,24.91,205,75.09,273,99.64,1,0.36,274
1,WA,242,Kallaroo,718,39.78,1087,60.22,1805,99.18,15,0.82,1820
1,WA,243,Kambalda West,106,17.29,507,82.71,613,98.87,7,1.13,620
1,WA,240,Kardinya (Fremantle),192,48.36,205,51.64,397,99,4,1,401
1,WA,248,Kardinya (Tangney),732,47.66,804,52.34,1536,98.91,17,1.09,1553
1,WA,240,Kardinya West,380,48.66,401,51.34,781,98.86,9,1.14,790
1,WA,312,Karratha,345,31.42,753,68.58,1098,98.65,15,1.35,1113
1,WA,239,Karridale,111,31.99,236,68.01,347,98.86,4,1.14,351
1,WA,238,Karrinyup,955,53.38,834,46.62,1789,99.06,17,0.94,1806
1,WA,238,Karrinyup South,963,52.03,888,47.97,1851,98.88,21,1.12,1872
1,WA,238,Karrinyup West,822,55.8,651,44.2,1473,98.79,18,1.21,1491
1,WA,243,Katanning,308,22,1092,78,1400,98.66,19,1.34,1419
1,WA,243,Kellerberrin,77,14.72,446,85.28,523,99.43,3,0.57,526
1,WA,317,Kelmscott,448,34.25,860,65.75,1308,98.27,23,1.73,1331
1,WA,317,Kelmscott East,479,35.01,889,64.99,1368,99.35,9,0.65,1377
1,WA,317,Kelmscott North,363,39.67,552,60.33,915,99.35,6,0.65,921
1,WA,243,Kendenup,106,22.6,363,77.4,469,99.36,3,0.64,472
1,WA,247,Kensington,1027,61.17,652,38.83,1679,99.11,15,0.89,1694
1,WA,247,Kensington East,788,57.23,589,42.77,1377,99.49,7,0.51,1384
1,WA,317,Kenwick,545,37.64,903,62.36,1448,98.64,20,1.36,1468
1,WA,247,Kewdale,499,45.49,598,54.51,1097,98.92,12,1.08,1109
1,WA,247,Kewdale West,591,46.1,691,53.9,1282,99.23,10,0.77,1292
1,WA,237,Kiara,361,40.93,521,59.07,882,98.77,11,1.23,893
1,WA,243,King River,129,25.7,373,74.3,502,99.01,5,0.99,507
1,WA,242,Kingsley,980,42.79,1310,57.21,2290,98.79,28,1.21,2318
1,WA,242,Kingsley East,467,41.15,668,58.85,1135,99.13,10,0.87,1145
1,WA,242,Kingsley South,608,48.1,656,51.9,1264,98.98,13,1.02,1277
1,WA,242,Kinross,664,35.08,1229,64.92,1893,98.95,20,1.05,1913
1,WA,242,Kinross East,72,40.91,104,59.09,176,100,0,0,176
1,WA,239,Kirup,64,26.56,177,73.44,241,97.18,7,2.82,248
1,WA,243,Kojonup,114,16.17,591,83.83,705,99.86,1,0.14,706
1,WA,243,Kondinin,48,29.09,117,70.91,165,99.4,1,0.6,166
1,WA,237,Koondoola,453,43.85,580,56.15,1033,98.38,17,1.62,1050
1,WA,243,Koorda,25,13.37,162,86.63,187,100,0,0,187
1,WA,243,Kulin,63,23.6,204,76.4,267,100,0,0,267
1,WA,312,Kununurra,295,43.77,379,56.23,674,98.83,8,1.17,682
1,WA,312,Kununurra PPVC,382,36,679,64,1061,99.44,6,0.56,1067
1,WA,235,Kwinana Town Centre PPVC,2230,30.07,5185,69.93,7415,99.37,47,0.63,7462
1,WA,236,Lake Clifton,35,13.73,220,86.27,255,98.46,4,1.54,259
1,WA,240,Lake Coogee,453,38.49,724,61.51,1177,99.07,11,0.93,1188
1,WA,243,Lake Grace,57,17.17,275,82.83,332,100,0,0,332
1,WA,243,Lake King,5,7.14,65,92.86,70,100,0,0,70
1,WA,236,Lakelands,519,31.42,1133,68.58,1652,98.1,32,1.9,1684
1,WA,312,Lancelin,119,19.83,481,80.17,600,99.83,1,0.17,601
1,WA,244,Landsdale,1004,35.72,1807,64.28,2811,98.91,31,1.09,2842
1,WA,244,Landsdale East,435,40.47,640,59.53,1075,98.81,13,1.19,1088
1,WA,244,Landsdale West,233,38.51,372,61.49,605,99.02,6,0.98,611
1,WA,317,Langford,630,46.56,723,53.44,1353,98.11,26,1.89,1379
1,WA,247,Lathlain,1025,57.84,747,42.16,1772,99.05,17,0.95,1789
1,WA,243,Laverton,17,22.08,60,77.92,77,98.72,1,1.28,78
1,WA,235,Leda,512,38.73,810,61.27,1322,98,27,2,1349
1,WA,312,Ledge Point,17,11.89,126,88.11,143,100,0,0,143
1,WA,245,Leederville,469,68.77,213,31.23,682,99.27,5,0.73,687
1,WA,245,Leederville North,546,62.54,327,37.46,873,99.43,5,0.57,878
1,WA,245,Leederville South,591,65.96,305,34.04,896,99.45,5,0.55,901
1,WA,312,Leeman,39,10.43,335,89.57,374,99.47,2,0.53,376
1,WA,248,Leeming,631,42.38,858,57.62,1489,99.13,13,0.87,1502
1,WA,248,Leeming East,538,41.71,752,58.29,1290,98.47,20,1.53,1310
1,WA,248,Leeming West,644,43.25,845,56.75,1489,98.94,16,1.06,1505
1,WA,243,Leinster,24,24,76,76,100,100,0,0,100
1,WA,243,Leonora,32,20.78,122,79.22,154,100,0,0,154
1,WA,239,Leschenault,75,27.17,201,72.83,276,99.64,1,0.36,277
1,WA,305,Lesmurdie,366,35.67,660,64.33,1026,99.23,8,0.77,1034
1,WA,305,Lesmurdie North,469,48.75,493,51.25,962,99.18,8,0.82,970
1,WA,243,Little Grove,248,39.3,383,60.7,631,99.37,4,0.63,635
1,WA,237,Lockridge,398,39.56,608,60.44,1006,98.15,19,1.85,1025
1,WA,243,Lockyer,391,27.83,1014,72.17,1405,98.6,20,1.4,1425
1,WA,312,Lower Chittering,158,17.19,761,82.81,919,99.14,8,0.86,927
1,WA,248,Lynwood,473,45.26,572,54.74,1045,98.77,13,1.23,1058
1,WA,317,Maddington,520,36.62,900,63.38,1420,98.07,28,1.93,1448
1,WA,317,Maddington BURT PPVC,2840,25.92,8116,74.08,10956,99.53,52,0.47,11008
1,WA,317,Maddington East,433,38.25,699,61.75,1132,99.3,8,0.7,1140
1,WA,248,Maddington TANGNEY PPVC,341,25.87,977,74.13,1318,99.47,7,0.53,1325
1,WA,244,Madeley,602,38.76,951,61.24,1553,99.36,10,0.64,1563
1,WA,237,Madeley COWAN PPVC,1966,30.17,4550,69.83,6516,98.88,74,1.12,6590
1,WA,244,Madeley PEARCE PPVC,1933,28.39,4875,71.61,6808,99.42,40,0.58,6848
1,WA,236,Madora Bay,362,32.88,739,67.12,1101,99.01,11,0.99,1112
1,WA,305,Mahogany Creek,231,37.32,388,62.68,619,99.04,6,0.96,625
1,WA,305,Maida Vale (Hasluck),160,38.28,258,61.72,418,98.35,7,1.65,425
1,WA,247,Maida Vale (Swan),414,28.83,1022,71.17,1436,99.17,12,0.83,1448
1,WA,237,Malaga COWAN PPVC,2534,29.61,6025,70.39,8559,98.87,98,1.13,8657
1,WA,305,Malaga HASLUCK PPVC,440,29.47,1053,70.53,1493,99.4,9,0.6,1502
1,WA,244,Malaga PEARCE PPVC,155,25.75,447,74.25,602,99.01,6,0.99,608
1,WA,236,Mandurah,120,37.04,204,62.96,324,97.59,8,2.41,332
1,WA,236,Mandurah Central,276,34.8,517,65.2,793,99.13,7,0.88,800
1,WA,236,Mandurah East,139,31.17,307,68.83,446,98.24,8,1.76,454
1,WA,236,Mandurah PPVC,905,22.1,3190,77.9,4095,99.34,27,0.66,4122
1,WA,243,Manjimup,145,25.31,428,74.69,573,99.13,5,0.87,578
1,WA,243,Manjimup East,119,22.97,399,77.03,518,98.85,6,1.15,524
1,WA,243,Manjimup PPVC,575,15.83,3058,84.17,3633,99.53,17,0.47,3650
1,WA,247,Manning,658,47.03,741,52.97,1399,99.08,13,0.92,1412
1,WA,247,Manning East,536,45.04,654,54.96,1190,99.08,11,0.92,1201
1,WA,247,Manning North,608,52.73,545,47.27,1153,98.89,13,1.11,1166
1,WA,237,Marangaroo,420,40.08,628,59.92,1048,98.59,15,1.41,1063
1,WA,237,Marangaroo Central,355,34.53,673,65.47,1028,98.75,13,1.25,1041
1,WA,237,Marangaroo East,596,39.39,917,60.61,1513,98.44,24,1.56,1537
1,WA,312,Marble Bar,19,40.43,28,59.57,47,95.92,2,4.08,49
1,WA,239,Margaret River,989,56.39,765,43.61,1754,98.37,29,1.63,1783
1,WA,239,Margaret River PPVC,2012,53.44,1753,46.56,3765,98.97,39,1.03,3804
1,WA,239,Margaret River South,209,57.58,154,42.42,363,97.84,8,2.16,371
1,WA,242,Marmion,654,48.27,701,51.73,1355,99.19,11,0.81,1366
1,WA,245,Maylands,958,62.45,576,37.55,1534,98.97,16,1.03,1550
1,WA,245,Maylands East,1212,64.13,678,35.87,1890,99.11,17,0.89,1907
1,WA,236,Meadow Springs,248,27.62,650,72.38,898,98.79,11,1.21,909
1,WA,236,Meadow Springs North,293,32.77,601,67.23,894,99.11,8,0.89,902
1,WA,235,Medina,427,39.46,655,60.54,1082,98.54,16,1.46,1098
1,WA,312,Meekatharra,73,41.01,105,58.99,178,99.44,1,0.56,179
1,WA,248,Melville,417,53.74,359,46.26,776,98.6,11,1.4,787
1,WA,248,Melville East,1125,54.03,957,45.97,2082,99.38,13,0.62,2095
1,WA,248,Melville South,298,49.58,303,50.42,601,99.34,4,0.66,605
1,WA,243,Merredin,102,21.12,381,78.88,483,99.59,2,0.41,485
1,WA,243,Merredin PPVC,213,15.14,1194,84.86,1407,99.5,7,0.5,1414
1,WA,244,Merriwa,376,34.75,706,65.25,1082,98.81,13,1.19,1095
1,WA,244,Merriwa East,240,35.29,440,64.71,680,98.98,7,1.02,687
1,WA,305,Midland,577,45.04,704,54.96,1281,99.23,10,0.77,1291
1,WA,312,Midland DURACK PPVC,128,19.1,542,80.9,670,99.85,1,0.15,671
1,WA,305,Midland HASLUCK PPVC,3601,28.6,8992,71.4,12593,99.36,81,0.64,12674
1,WA,305,Midland North,547,38.88,860,61.12,1407,98.46,22,1.54,1429
1,WA,247,Midland SWAN PPVC,303,25.42,889,74.58,1192,99.33,8,0.67,1200
1,WA,312,Miling,10,12.2,72,87.8,82,100,0,0,82
1,WA,312,Millars Well,508,38.75,803,61.25,1311,99.39,8,0.61,1319
1,WA,244,Mindarie,565,32.03,1199,67.97,1764,99.16,15,0.84,1779
1,WA,244,Mindarie North,184,34.26,353,65.74,537,99.44,3,0.56,540
1,WA,312,Mingenew,26,13.76,163,86.24,189,100,0,0,189
1,WA,237,Mirrabooka Central,575,45.63,685,54.37,1260,97.37,34,2.63,1294
1,WA,237,Mirrabooka East,526,43.98,670,56.02,1196,97.63,29,2.37,1225
1,WA,312,Moonyoonooka,12,7.32,152,92.68,164,98.8,2,1.2,166
1,WA,312,Moora,159,19.09,674,80.91,833,98.35,14,1.65,847
1,WA,312,Morawa,69,27.38,183,72.62,252,99.6,1,0.4,253
1,WA,237,Morley (Cowan),231,39.02,361,60.98,592,98.83,7,1.17,599
1,WA,245,Morley (Perth),533,43.83,683,56.17,1216,98.7,16,1.3,1232
1,WA,237,Morley Central (Cowan),334,43.43,435,56.57,769,99.1,7,0.9,776
1,WA,245,Morley Central (Perth),148,46.25,172,53.75,320,99.07,3,0.93,323
1,WA,237,Morley COWAN PPVC,2138,28.69,5314,71.31,7452,98.78,92,1.22,7544
1,WA,305,Morley HASLUCK PPVC,240,32.88,490,67.12,730,99.59,3,0.41,733
1,WA,245,Morley PERTH PPVC,4273,39.06,6666,60.94,10939,99.04,106,0.96,11045
1,WA,237,Morley South (Cowan),388,39.96,583,60.04,971,98.28,17,1.72,988
1,WA,245,Morley South (Perth),235,40.17,350,59.83,585,97.99,12,2.01,597
1,WA,238,Mosman Park,871,51.42,823,48.58,1694,99.12,15,0.88,1709
1,WA,243,Mount Barker,348,26.48,966,73.52,1314,97.91,28,2.09,1342
1,WA,238,Mount Claremont,1101,57.58,811,42.42,1912,99.27,14,0.73,1926
1,WA,238,Mount Claremont East,330,59.03,229,40.97,559,98.76,7,1.24,566
1,WA,243,Mount Clarence,253,47.2,283,52.8,536,99.63,2,0.37,538
1,WA,245,Mount Hawthorn,1604,66.81,797,33.19,2401,99.26,18,0.74,2419
1,WA,305,Mount Helena,246,32.03,522,67.97,768,99.35,5,0.65,773
1,WA,245,Mount Lawley,1357,64.71,740,35.29,2097,98.78,26,1.22,2123
1,WA,245,Mount Lawley East,409,67.38,198,32.62,607,99.18,5,0.82,612
1,WA,245,Mount Lawley South,617,62.51,370,37.49,987,99.1,9,0.9,996
1,WA,245,Mount Lawley West,252,58.6,178,41.4,430,99.54,2,0.46,432
1,WA,312,Mount Magnet,29,18.59,127,81.41,156,99.36,1,0.64,157
1,WA,248,Mount Pleasant,938,46.62,1074,53.38,2012,99.16,17,0.84,2029
1,WA,312,Mount Tarcoola,267,28.56,668,71.44,935,98.84,11,1.16,946
1,WA,243,Mukinbudin,23,9.2,227,90.8,250,100,0,0,250
1,WA,242,Mullaloo,878,43.44,1143,56.56,2021,98.83,24,1.17,2045
1,WA,312,Mullewa,42,21.32,155,78.68,197,98.99,2,1.01,199
1,WA,305,Mundaring,440,41.75,614,58.25,1054,98.69,14,1.31,1068
1,WA,305,Mundaring PPVC,1513,29.33,3645,70.67,5158,99.38,32,0.62,5190
1,WA,236,Mundijong,201,20.62,774,79.38,975,99.19,8,0.81,983
1,WA,243,Munglinup,8,10,72,90,80,97.56,2,2.44,82
1,WA,243,Muradup,22,17.32,105,82.68,127,100,0,0,127
1,WA,312,Nabawa,24,14.04,147,85.96,171,100,0,0,171
1,WA,243,Nannup,258,38.45,413,61.55,671,98.53,10,1.47,681
1,WA,243,Napier,23,17.83,106,82.17,129,99.23,1,0.77,130
1,WA,243,Narembeen,38,12.42,268,87.58,306,99.35,2,0.65,308
1,WA,243,Narrikup,46,22.22,161,77.78,207,98.1,4,1.9,211
1,WA,243,Narrogin,197,24.59,604,75.41,801,99.26,6,0.74,807
1,WA,243,Narrogin PPVC,404,17.32,1929,82.68,2333,99.53,11,0.47,2344
1,WA,238,Nedlands Central,404,68.59,185,31.41,589,98.83,7,1.17,596
1,WA,238,Nedlands North,669,59.2,461,40.8,1130,99.56,5,0.44,1135
1,WA,238,Nedlands South,964,57.18,722,42.82,1686,99.12,15,0.88,1701
1,WA,312,New Norcia,26,19.85,105,80.15,131,100,0,0,131
1,WA,243,Newdegate,12,8.22,134,91.78,146,100,0,0,146
1,WA,312,Newman,372,35.6,673,64.4,1045,98.68,14,1.32,1059
1,WA,312,Nickol,670,37.14,1134,62.86,1804,99.12,16,0.88,1820
1,WA,237,Nollamara,889,49.14,920,50.86,1809,98.85,21,1.15,1830
1,WA,237,Noranda,697,39.29,1077,60.71,1774,98.56,26,1.44,1800
1,WA,237,Noranda West,690,44.69,854,55.31,1544,97.11,46,2.89,1590
1,WA,243,Norseman,56,22.67,191,77.33,247,99.6,1,0.4,248
1,WA,242,North Beach,902,48.97,940,51.03,1842,98.77,23,1.23,1865
1,WA,242,North Beach Central,243,46.37,281,53.63,524,99.43,3,0.57,527
1,WA,236,North Dandalup,72,16.33,369,83.67,441,98,9,2,450
1,WA,240,North Fremantle,793,64.52,436,35.48,1229,99.19,10,0.81,1239
1,WA,245,North Perth,1058,69.97,454,30.03,1512,99.28,11,0.72,1523
1,WA,245,North Perth Central,1502,69.83,649,30.17,2151,99.03,21,0.97,2172
1,WA,236,North Yunderup,58,16.29,298,83.71,356,98.34,6,1.66,362
1,WA,312,Northam,274,27.96,706,72.04,980,99.29,7,0.71,987
1,WA,312,Northam East,63,26.14,178,73.86,241,98.37,4,1.63,245
1,WA,312,Northam PPVC,834,17.54,3920,82.46,4754,99.41,28,0.59,4782
1,WA,312,Northampton,116,18.53,510,81.47,626,99.21,5,0.79,631
1,WA,245,Northbridge,506,68.29,235,31.71,741,98.67,10,1.33,751
1,WA,243,Northcliffe,117,37.99,191,62.01,308,99.35,2,0.65,310
1,WA,243,Nulsen,190,33.1,384,66.9,574,99.48,3,0.52,577
1,WA,243,Nyabing,13,10.74,108,89.26,121,99.18,1,0.82,122
1,WA,248,O'Connor PPVC,2748,36.12,4860,63.88,7608,99.57,33,0.43,7641
1,WA,242,Ocean Reef,305,29.05,745,70.95,1050,99.06,10,0.94,1060
1,WA,242,Ocean Reef North,640,39.9,964,60.1,1604,98.89,18,1.11,1622
1,WA,242,Ocean Reef South,270,40.85,391,59.15,661,99.1,6,0.9,667
1,WA,243,Ongerup,24,19.83,97,80.17,121,99.18,1,0.82,122
1,WA,312,Onslow,143,40.97,206,59.03,349,99.43,2,0.57,351
1,WA,237,Osborne Park (Cowan),534,45.96,628,54.04,1162,99.32,8,0.68,1170
1,WA,245,Osborne Park (Perth),414,54.83,341,45.17,755,99.08,7,0.92,762
1,WA,237,Osborne Park COWAN PPVC,492,34.1,951,65.9,1443,98.7,19,1.3,1462
1,WA,238,Osborne Park CURTIN PPVC,3692,41.58,5188,58.42,8880,99.25,67,0.75,8947
1,WA,245,Osborne Park PERTH PPVC,1635,45.93,1925,54.07,3560,99.27,26,0.73,3586
1,WA,245,Other Mobile Team 1,38,64.41,21,35.59,59,98.33,1,1.67,60
1,WA,240,Other Mobile Team 1,9,47.37,10,52.63,19,100,0,0,19
1,WA,242,Padbury,572,45.54,684,54.46,1256,98.51,19,1.49,1275
1,WA,242,Padbury South,996,45.67,1185,54.33,2181,99.32,15,0.68,2196
1,WA,240,Palmyra,1339,65.35,710,34.65,2049,99.27,15,0.73,2064
1,WA,240,Palmyra North,489,63.92,276,36.08,765,97.7,18,2.3,783
1,WA,312,Pannawonica,33,25.98,94,74.02,127,98.45,2,1.55,129
1,WA,312,Paraburdoo,118,34.4,225,65.6,343,99.42,2,0.58,345
1,WA,305,Parkerville,437,39.73,663,60.27,1100,98.39,18,1.61,1118
1,WA,248,Parkwood,584,42.82,780,57.18,1364,99.34,9,0.66,1373
1,WA,235,Parmelia,341,33.27,684,66.73,1025,98.94,11,1.06,1036
1,WA,244,Pearsall,642,35.71,1156,64.29,1798,98.95,19,1.05,1817
1,WA,243,Pemberton,153,32.42,319,67.58,472,99.37,3,0.63,475
1,WA,238,Peppermint Grove,961,53.24,844,46.76,1805,99.07,17,0.93,1822
1,WA,312,Perenjori,21,17.5,99,82.5,120,99.17,1,0.83,121
1,WA,245,Perth,602,56.37,466,43.63,1068,99.26,8,0.74,1076
1,WA,238,Perth CURTIN PPVC,988,53.93,844,46.07,1832,99.03,18,0.97,1850
1,WA,240,Perth FREMANTLE PPVC,456,54.42,382,45.58,838,99.17,7,0.83,845
1,WA,242,Perth MOORE PPVC,399,43.99,508,56.01,907,98.91,10,1.09,917
1,WA,245,Perth PERTH PPVC,3147,55.42,2531,44.58,5678,98.97,59,1.03,5737
1,WA,247,Perth SWAN PPVC,1036,51.34,982,48.66,2018,99.41,12,0.59,2030
1,WA,248,Perth TANGNEY PPVC,566,45.53,677,54.47,1243,98.89,14,1.11,1257
1,WA,317,Piara Waters,1097,43.64,1417,56.36,2514,98.82,30,1.18,2544
1,WA,317,Piara Waters South,795,49.66,806,50.34,1601,99.44,9,0.56,1610
1,WA,236,Pickering Brook,122,28.24,310,71.76,432,98.41,7,1.59,439
1,WA,243,Pingelly,70,13.54,447,86.46,517,99.04,5,0.96,522
1,WA,243,Pingrup,18,14.52,106,85.48,124,100,0,0,124
1,WA,236,Pinjarra,271,20.69,1039,79.31,1310,99.17,11,0.83,1321
1,WA,236,Pinjarra North,79,17.59,370,82.41,449,98.03,9,1.97,458
1,WA,243,Porongurup,73,37.06,124,62.94,197,98.99,2,1.01,199
1,WA,312,Port Hedland,293,35.95,522,64.05,815,99.39,5,0.61,820
1,WA,235,Port Kennedy,582,32.88,1188,67.12,1770,98.66,24,1.34,1794
1,WA,235,Port Kennedy East,278,29.89,652,70.11,930,99.25,7,0.75,937
1,WA,235,Port Kennedy PPVC,3058,23.83,9775,76.17,12833,99.31,89,0.69,12922
1,WA,236,Preston Beach,24,19.83,97,80.17,121,98.37,2,1.63,123
1,WA,243,Quairading,78,17.81,360,82.19,438,100,0,0,438
1,WA,247,Queens Park,595,45.42,715,54.58,1310,98.79,16,1.21,1326
1,WA,243,Quinninup,28,52.83,25,47.17,53,98.15,1,1.85,54
1,WA,244,Quinns Rocks,317,35.34,580,64.66,897,99.23,7,0.77,904
1,WA,244,Quinns Rocks North,505,36.7,871,63.3,1376,99.28,10,0.72,1386
1,WA,312,Rangeway,300,32.82,614,67.18,914,98.92,10,1.08,924
1,WA,243,Ravensthorpe,46,20.26,181,79.74,227,99.13,2,0.87,229
1,WA,247,Redcliffe,453,45.8,536,54.2,989,99,10,1,999
1,WA,243,Redmond,22,21.15,82,78.85,104,100,0,0,104
1,WA,312,Remote Mobile Team 1,237,66.02,122,33.98,359,98.9,4,1.1,363
1,WA,243,Remote Mobile Team 1,88,55,72,45,160,99.38,1,0.62,161
1,WA,312,Remote Mobile Team 2,173,80.47,42,19.53,215,99.54,1,0.46,216
1,WA,243,Remote Mobile Team 2,126,50.81,122,49.19,248,97.25,7,2.75,255
1,WA,312,Remote Mobile Team 3,208,82.87,43,17.13,251,99.21,2,0.79,253
1,WA,243,Remote Mobile Team 3,23,30.67,52,69.33,75,100,0,0,75
1,WA,312,Remote Mobile Team 4,138,80.23,34,19.77,172,100,0,0,172
1,WA,243,Remote Mobile Team 4,2,2.7,72,97.3,74,100,0,0,74
1,WA,312,Remote Mobile Team 5,49,25.26,145,74.74,194,100,0,0,194
1,WA,243,Remote Mobile Team 5,10,10.2,88,89.8,98,100,0,0,98
1,WA,312,Remote Mobile Team 6,223,74.33,77,25.67,300,98.04,6,1.96,306
1,WA,312,Remote Mobile Team 7,198,89.19,24,10.81,222,100,0,0,222
1,WA,312,Remote Mobile Team 8,47,64.38,26,35.62,73,100,0,0,73
1,WA,312,Remote Mobile Team 9,63,70,27,30,90,98.9,1,1.1,91
1,WA,248,Riverton,656,45.87,774,54.13,1430,99.24,11,0.76,1441
1,WA,247,Rivervale,530,50.28,524,49.72,1054,98.97,11,1.03,1065
1,WA,247,Rivervale North,514,49.33,528,50.67,1042,99.33,7,0.67,1049
1,WA,235,Rockingham,625,33.48,1242,66.52,1867,98.78,23,1.22,1890
1,WA,235,Rockingham Central,250,42.81,334,57.19,584,98.48,9,1.52,593
1,WA,235,Rockingham Central PPVC,1213,28.05,3112,71.95,4325,99.22,34,0.78,4359
1,WA,235,Rockingham North,340,37.32,571,62.68,911,99.45,5,0.55,916
1,WA,235,Rockingham PPVC,3677,24.77,11166,75.23,14843,99.17,124,0.83,14967
1,WA,312,Roebourne,99,68.75,45,31.25,144,100,0,0,144
1,WA,236,Roleystone,731,35.11,1351,64.89,2082,99.24,16,0.76,2098
1,WA,236,Roleystone North,281,38.65,446,61.35,727,98.51,11,1.49,738
1,WA,239,Rosa Brook,81,38.57,129,61.43,210,99.06,2,0.94,212
1,WA,248,Rossmoyne,557,46.73,635,53.27,1192,99,12,1,1204
1,WA,235,Safety Bay,695,39.56,1062,60.44,1757,98.65,24,1.35,1781
1,WA,235,Safety Bay Central,412,35.86,737,64.14,1149,99.22,9,0.78,1158
1,WA,240,Samson,692,50,692,50,1384,99.07,13,0.93,1397
1,WA,305,Sawyers Valley,147,32.1,311,67.9,458,98.71,6,1.29,464
1,WA,238,Scarborough,1011,56.67,773,43.33,1784,99.17,15,0.83,1799
1,WA,238,Scarborough North,334,60.4,219,39.6,553,99.46,3,0.54,556
1,WA,243,Scotsdale,248,47.42,275,52.58,523,98.68,7,1.32,530
1,WA,312,Seabird,35,25,105,75,140,99.29,1,0.71,141
1,WA,235,Secret Harbour,572,32.28,1200,67.72,1772,98.99,18,1.01,1790
1,WA,235,Secret Harbour South,453,33.73,890,66.27,1343,99.11,12,0.89,1355
1,WA,236,Serpentine,207,20.72,792,79.28,999,99.11,9,0.89,1008
1,WA,317,Seville Grove,621,31.05,1379,68.95,2000,98.77,25,1.23,2025
1,WA,248,Shelley,497,44.18,628,55.82,1125,99.38,7,0.62,1132
1,WA,238,Shenton Park PPVC,4573,46.04,5359,53.96,9932,99.58,42,0.42,9974
1,WA,238,Shenton Park West,878,71.15,356,28.85,1234,99.36,8,0.64,1242
1,WA,235,Singleton,569,35.85,1018,64.15,1587,99.06,15,0.94,1602
1,WA,243,Somerville,201,18.26,900,81.74,1101,98.83,13,1.17,1114
1,WA,242,Sorrento,636,53.22,559,46.78,1195,99.5,6,0.5,1201
1,WA,242,Sorrento Beach,400,34.9,746,65.1,1146,99.22,9,0.78,1155
1,WA,312,South Hedland,315,37.5,525,62.5,840,98.02,17,1.98,857
1,WA,312,South Hedland East,278,32.48,578,67.52,856,99.65,3,0.35,859
1,WA,312,South Hedland PPVC,601,29.4,1443,70.6,2044,99.9,2,0.1,2046
1,WA,240,South Lake,777,39.38,1196,60.62,1973,98.65,27,1.35,2000
1,WA,247,South Perth,867,48.6,917,51.4,1784,99.33,12,0.67,1796
1,WA,247,South Perth Central,751,46.94,849,53.06,1600,99.19,13,0.81,1613
1,WA,247,South Perth West,308,44.64,382,55.36,690,99.57,3,0.43,693
1,WA,236,South Yunderup,250,21.51,912,78.49,1162,99.23,9,0.77,1171
1,WA,243,Southern Cross,45,12.53,314,87.47,359,99.17,3,0.83,362
1,WA,317,Southern River,930,38.64,1477,61.36,2407,99.09,22,0.91,2429
1,WA,317,Southern River East,509,43.62,658,56.38,1167,98.81,14,1.19,1181
1,WA,240,Spearwood,725,50.73,704,49.27,1429,98.69,19,1.31,1448
1,WA,240,Spearwood PPVC,4204,33.4,8382,66.6,12586,98.79,154,1.21,12740
1,WA,240,Spearwood South,393,41.59,552,58.41,945,99.06,9,0.94,954
1,WA,245,Special Hospital Team 1,110,52.63,99,47.37,209,99.05,2,0.95,211
1,WA,305,Special Hospital Team 1,94,53.11,83,46.89,177,98.88,2,1.12,179
1,WA,235,Special Hospital Team 1,76,32.07,161,67.93,237,99.16,2,0.84,239
1,WA,237,Special Hospital Team 1,81,47.93,88,52.07,169,97.69,4,2.31,173
1,WA,242,Special Hospital Team 1,83,51.55,78,48.45,161,98.77,2,1.23,163
1,WA,240,Special Hospital Team 1,58,60.42,38,39.58,96,96.97,3,3.03,99
1,WA,312,Special Hospital Team 1,63,32.31,132,67.69,195,93.3,14,6.7,209
1,WA,239,Special Hospital Team 1,196,60.12,130,39.88,326,98.19,6,1.81,332
1,WA,248,Special Hospital Team 1,96,48,104,52,200,98.04,4,1.96,204
1,WA,317,Special Hospital Team 1,43,39.09,67,60.91,110,96.49,4,3.51,114
1,WA,238,Special Hospital Team 1,129,47.6,142,52.4,271,97.48,7,2.52,278
1,WA,236,Special Hospital Team 1,141,36.81,242,63.19,383,97.95,8,2.05,391
1,WA,247,Special Hospital Team 1,82,48.24,88,51.76,170,98.27,3,1.73,173
1,WA,243,Special Hospital Team 1,25,36.23,44,63.77,69,100,0,0,69
1,WA,244,Special Hospital Team 1,100,44.64,124,55.36,224,99.56,1,0.44,225
1,WA,239,Special Hospital Team 2,53,39.26,82,60.74,135,93.1,10,6.9,145
1,WA,247,Special Hospital Team 2,87,47.54,96,52.46,183,95.81,8,4.19,191
1,WA,243,Special Hospital Team 2,82,42.93,109,57.07,191,99.48,1,0.52,192
1,WA,235,Special Hospital Team 2,42,40.38,62,59.62,104,96.3,4,3.7,108
1,WA,317,Special Hospital Team 2,77,50.33,76,49.67,153,95.63,7,4.38,160
1,WA,240,Special Hospital Team 2,105,57.38,78,42.62,183,95.31,9,4.69,192
1,WA,248,Special Hospital Team 2,119,48.77,125,51.23,244,97.6,6,2.4,250
1,WA,312,Special Hospital Team 2,24,44.44,30,55.56,54,98.18,1,1.82,55
1,WA,236,Special Hospital Team 2,43,37.39,72,62.61,115,99.14,1,0.86,116
1,WA,238,Special Hospital Team 2,132,53.23,116,46.77,248,98.41,4,1.59,252
1,WA,245,Special Hospital Team 2,66,62.26,40,37.74,106,97.25,3,2.75,109
1,WA,312,Special Hospital Team 3,13,36.11,23,63.89,36,100,0,0,36
1,WA,243,Special Hospital Team 3,0,0,0,0,0,0,0,0,0
1,WA,238,Special Hospital Team 3,176,46.44,203,53.56,379,99.74,1,0.26,380
1,WA,245,Special Hospital Team 3,72,48.65,76,51.35,148,98.01,3,1.99,151
1,WA,312,Special Hospital Team 4,13,54.17,11,45.83,24,100,0,0,24
1,WA,243,Special Hospital Team 4,39,30.23,90,69.77,129,98.47,2,1.53,131
1,WA,312,Special Hospital Team 5,4,30.77,9,69.23,13,100,0,0,13
1,WA,243,Special Hospital Team 5,17,27.87,44,72.13,61,96.83,2,3.17,63
1,WA,312,Special Hospital Team 6,6,75,2,25,8,100,0,0,8
1,WA,243,Special Hospital Team 6,6,42.86,8,57.14,14,93.33,1,6.67,15
1,WA,312,Special Hospital Team 7,7,63.64,4,36.36,11,100,0,0,11
1,WA,243,Spencer Park,352,35.31,645,64.69,997,98.81,12,1.19,1009
1,WA,305,Stratton,398,36.78,684,63.22,1082,98.72,14,1.28,1096
1,WA,305,Stratton North,428,32.57,886,67.43,1314,99.32,9,0.68,1323
1,WA,238,Subiaco,370,63.9,209,36.1,579,99.14,5,0.86,584
1,WA,238,Subiaco Central,1149,60.89,738,39.11,1887,98.9,21,1.1,1908
1,WA,238,Subiaco CURTIN PPVC,3905,46.63,4469,53.37,8374,99.37,53,0.63,8427
1,WA,245,Subiaco PERTH PPVC,1452,58.38,1035,41.62,2487,99.2,20,0.8,2507
1,WA,240,Success,675,42.83,901,57.17,1576,99.06,15,0.94,1591
1,WA,240,Success North,756,43.25,992,56.75,1748,98.81,21,1.19,1769
1,WA,305,Swan View,599,30.56,1361,69.44,1960,98.79,24,1.21,1984
1,WA,305,Swan View East,218,41.84,303,58.16,521,98.86,6,1.14,527
1,WA,238,Swanbourne,998,56.07,782,43.93,1780,99.44,10,0.56,1790
1,WA,243,Tambellup,51,22.97,171,77.03,222,99.11,2,0.89,224
1,WA,243,Tammin,39,24.68,119,75.32,158,98.75,2,1.25,160
1,WA,244,Tapping,527,33.5,1046,66.5,1573,98.56,23,1.44,1596
1,WA,244,Tapping South,419,37.54,697,62.46,1116,99.02,11,0.98,1127
1,WA,317,Thornlie,624,40.26,926,59.74,1550,98.16,29,1.84,1579
1,WA,317,Thornlie Central,325,39.49,498,60.51,823,99.16,7,0.84,830
1,WA,317,Thornlie East,521,42.39,708,57.61,1229,98.32,21,1.68,1250
1,WA,317,Thornlie South,578,36.1,1023,63.9,1601,99.01,16,0.99,1617
1,WA,317,Thornlie West,506,37.7,836,62.3,1342,98.46,21,1.54,1363
1,WA,312,Three Springs,38,17.27,182,82.73,220,99.1,2,0.9,222
1,WA,243,Tingledale,64,34.04,124,65.96,188,99.47,1,0.53,189
1,WA,312,Tom Price,256,31.26,563,68.74,819,99.15,7,0.85,826
1,WA,312,Toodyay,315,24.78,956,75.22,1271,98.83,15,1.17,1286
1,WA,243,Trayning,15,11.36,117,88.64,132,100,0,0,132
1,WA,240,Treeby,668,46.23,777,53.77,1445,99.24,11,0.76,1456
1,WA,245,Tuart Hill,1043,56.56,801,43.44,1844,98.82,22,1.18,1866
1,WA,237,Tuart Hill West (Cowan),32,40,48,60,80,98.77,1,1.23,81
1,WA,245,Tuart Hill West (Perth),322,51.85,299,48.15,621,99.68,2,0.32,623
1,WA,244,Two Rocks,174,25.85,499,74.15,673,98.25,12,1.75,685
1,WA,305,Upper Swan,322,27.36,855,72.64,1177,99.24,9,0.76,1186
1,WA,239,Vasse,674,39.55,1030,60.45,1704,98.44,27,1.56,1731
1,WA,247,Victoria Park,968,54.78,799,45.22,1767,99.16,15,0.84,1782
1,WA,312,Waggrakine,299,27.63,783,72.37,1082,99.91,1,0.09,1083
1,WA,243,Wagin,116,14.99,658,85.01,774,98.22,14,1.78,788
1,WA,235,Waikiki,537,35.94,957,64.06,1494,98.68,20,1.32,1514
1,WA,235,Waikiki East,398,32.23,837,67.77,1235,99.2,10,0.8,1245
1,WA,312,Walkaway,33,12.74,226,87.26,259,98.85,3,1.15,262
1,WA,305,Walliston,480,37.01,817,62.99,1297,98.78,16,1.22,1313
1,WA,243,Walpole,143,39.39,220,60.61,363,97.32,10,2.68,373
1,WA,243,Wandering,28,14,172,86,200,100,0,0,200
1,WA,235,Wandi,602,40.08,900,59.92,1502,99.54,7,0.46,1509
1,WA,312,Wandina,192,26.3,538,73.7,730,98.78,9,1.22,739
1,WA,236,Wannanup,377,31.63,815,68.37,1192,98.43,19,1.57,1211
1,WA,244,Wanneroo,385,34.81,721,65.19,1106,99.1,10,0.9,1116
1,WA,244,Wanneroo East,442,29.45,1059,70.55,1501,98.82,18,1.18,1519
1,WA,242,Wanneroo MOORE PPVC,310,26.96,840,73.04,1150,99.05,11,0.95,1161
1,WA,244,Wanneroo North,424,36.39,741,63.61,1165,99.06,11,0.94,1176
1,WA,244,Wanneroo PEARCE PPVC,2764,27.2,7399,72.8,10163,99.28,74,0.72,10237
1,WA,235,Warnbro,380,34.93,708,65.07,1088,98.64,15,1.36,1103
1,WA,235,Warnbro East,377,33.42,751,66.58,1128,98.17,21,1.83,1149
1,WA,235,Warnbro North,241,36.02,428,63.98,669,98.96,7,1.04,676
1,WA,236,Waroona,205,15.08,1154,84.92,1359,98.62,19,1.38,1378
1,WA,237,Warwick,489,46.48,563,53.52,1052,98.69,14,1.31,1066
1,WA,312,Watheroo,15,17.65,70,82.35,85,98.84,1,1.16,86
1,WA,247,Wattle Grove,755,42.01,1042,57.99,1797,99.17,15,0.83,1812
1,WA,235,Wellard,186,28.97,456,71.03,642,99.53,3,0.47,645
1,WA,235,Wellard Central,451,39.84,681,60.16,1132,99.12,10,0.88,1142
1,WA,235,Wellard South,739,43.91,944,56.09,1683,99.29,12,0.71,1695
1,WA,243,Wellstead,18,14.29,108,85.71,126,97.67,3,2.33,129
1,WA,238,Wembley Central,317,62.16,193,37.84,510,99.22,4,0.78,514
1,WA,238,Wembley Downs,1122,54.87,923,45.13,2045,98.84,24,1.16,2069
1,WA,238,Wembley North,615,60.41,403,39.59,1018,98.74,13,1.26,1031
1,WA,238,Wembley West,1116,61.73,692,38.27,1808,98.96,19,1.04,1827
1,WA,238,West Leederville,984,64.65,538,35.35,1522,99.09,14,0.91,1536
1,WA,245,West Perth,502,64.36,278,35.64,780,98.86,9,1.14,789
1,WA,245,West Perth Central,406,56.78,309,43.22,715,99.31,5,0.69,720
1,WA,305,West Swan,335,39.5,513,60.5,848,98.95,9,1.05,857
1,WA,237,Westminster,727,45.81,860,54.19,1587,97.9,34,2.1,1621
1,WA,243,Westonia,19,19,81,81,100,100,0,0,100
1,WA,240,White Gum Valley,1087,73.95,383,26.05,1470,98.99,15,1.01,1485
1,WA,243,Wickepin,29,11.89,215,88.11,244,99.59,1,0.41,245
1,WA,312,Wickham,198,27.73,516,72.27,714,99.17,6,0.83,720
1,WA,248,Willagee,625,52.97,555,47.03,1180,98.99,12,1.01,1192
1,WA,248,Willagee East,350,48.08,378,51.92,728,98.91,8,1.09,736
1,WA,248,Willetton,712,47.59,784,52.41,1496,98.81,18,1.19,1514
1,WA,248,Willetton East,906,46.44,1045,53.56,1951,98.68,26,1.32,1977
1,WA,248,Willetton North,410,46.28,476,53.72,886,99.22,7,0.78,893
1,WA,248,Willetton PPVC,4924,33.25,9886,66.75,14810,99.44,84,0.56,14894
1,WA,248,Willetton South,769,47.53,849,52.47,1618,99.39,10,0.61,1628
1,WA,243,Williams,71,15.88,376,84.12,447,99.55,2,0.45,449
1,WA,248,Wilson,550,47.25,614,52.75,1164,98.98,12,1.02,1176
1,WA,248,Winthrop,917,42.85,1223,57.15,2140,99.44,12,0.56,2152
1,WA,239,Witchcliffe,247,53,219,47,466,97.69,11,2.31,477
1,WA,239,Withers,309,30.81,694,69.19,1003,98.53,15,1.47,1018
1,WA,239,Wollaston,189,29.21,458,70.79,647,98.63,9,1.37,656
1,WA,312,Wongan Hills,94,16.85,464,83.15,558,99.64,2,0.36,560
1,WA,312,Wonthella,287,25.22,851,74.78,1138,99.22,9,0.78,1147
1,WA,243,Woodanilling,36,16.07,188,83.93,224,99.56,1,0.44,225
1,WA,238,Woodlands,955,52.07,879,47.93,1834,98.87,21,1.13,1855
1,WA,312,Woodridge,102,18.68,444,81.32,546,98.56,8,1.44,554
1,WA,242,Woodvale,401,36.49,698,63.51,1099,98.83,13,1.17,1112
1,WA,242,Woodvale North,745,39.48,1142,60.52,1887,99,19,1,1906
1,WA,242,Woodvale South,300,42.49,406,57.51,706,99.44,4,0.56,710
1,WA,305,Wooroloo,74,25.96,211,74.04,285,98.62,4,1.38,289
1,WA,312,Wundowie,108,22.09,381,77.91,489,98.79,6,1.21,495
1,WA,243,Wyalkatchem,32,15.38,176,84.62,208,100,0,0,208
1,WA,312,Wyndham,132,60,88,40,220,100,0,0,220
1,WA,239,Yabberup,66,25.68,191,74.32,257,99.61,1,0.39,258
1,WA,243,Yakamia,290,26.27,814,73.73,1104,98.13,21,1.87,1125
1,WA,239,Yallingup,358,56.38,277,43.62,635,98.6,9,1.4,644
1,WA,239,Yalyalup,271,32.07,574,67.93,845,98.83,10,1.17,855
1,WA,244,Yanchep,261,33.85,510,66.15,771,98.22,14,1.78,785
1,WA,244,Yanchep North,321,34.41,612,65.59,933,99.26,7,0.74,940
1,WA,244,Yanchep PPVC,1232,25.56,3588,74.44,4820,99.03,47,0.97,4867
1,WA,240,Yangebup,710,43,941,57,1651,97.98,34,2.02,1685
1,WA,240,Yangebup South,143,42.06,197,57.94,340,99.13,3,0.87,343
1,WA,239,Yarloop,61,16.22,315,83.78,376,99.47,2,0.53,378
1,WA,245,Yokine,864,51.15,825,48.85,1689,99.29,12,0.71,1701
1,WA,245,Yokine North,461,46.19,537,53.81,998,98.91,11,1.09,1009
1,WA,245,Yokine West,230,49.36,236,50.64,466,97.69,11,2.31,477
1,WA,312,York,326,25.55,950,74.45,1276,99.07,12,0.93,1288
1,WA,243,Youngs Siding,109,36.82,187,63.18,296,100,0,0,296
