QuestionNo,StateAb,DivisionID,PollingPlaceNm,YesVotes,YesPercentage,NoVotes,NoPercentage,FormalVotes,FormalPercentage,InformalVotes,InformalPercentage,TotalVotes
1,QLD,173,Acacia Ridge,357,46.01,419,53.99,776,98.23,14,1.77,790
1,QLD,173,Acacia Ridge South (Moreton),657,44.79,810,55.21,1467,98.59,21,1.41,1488
1,QLD,174,Acacia Ridge South (Oxley),114,57.87,83,42.13,197,98.01,4,1.99,201
1,QLD,311,Agnes Water,169,23.06,564,76.94,733,98.92,8,1.08,741
1,QLD,311,Agnes Water PPVC,347,23.27,1144,76.73,1491,98.94,16,1.06,1507
1,QLD,158,Airlie Beach,244,26.87,664,73.13,908,98.16,17,1.84,925
1,QLD,158,Airlie Beach PPVC,704,21.18,2620,78.82,3324,98.9,37,1.1,3361
1,QLD,165,Aitkenvale,367,34.92,684,65.08,1051,98.32,18,1.68,1069
1,QLD,158,Aitkenvale DAWSON PPVC,486,20.63,1870,79.37,2356,99.37,15,0.63,2371
1,QLD,165,Aitkenvale HERBERT PPVC,2353,24.16,7387,75.84,9740,99.45,54,0.55,9794
1,QLD,167,Aitkenvale KENNEDY PPVC,86,15.64,464,84.36,550,99.64,2,0.36,552
1,QLD,252,Albany Creek,199,39.96,299,60.04,498,98.81,6,1.19,504
1,QLD,252,Albany Creek North,720,39.09,1122,60.91,1842,99.51,9,0.49,1851
1,QLD,252,Albany Creek South,797,39.53,1219,60.47,2016,99.26,15,0.74,2031
1,QLD,252,Albany Hills,612,42.95,813,57.05,1425,99.16,12,0.84,1437
1,QLD,159,Alberton,54,16.51,273,83.49,327,99.7,1,0.3,328
1,QLD,156,Alderley,632,60.54,412,39.46,1044,99.24,8,0.76,1052
1,QLD,155,Alexandra Hills,384,30.12,891,69.88,1275,98.91,14,1.09,1289
1,QLD,155,Alexandra Park,611,30,1426,70,2037,98.88,23,1.12,2060
1,QLD,176,Algester,670,43.59,867,56.41,1537,99.29,11,0.71,1548
1,QLD,176,Algester South,912,38.58,1452,61.42,2364,98.66,32,1.34,2396
1,QLD,165,Alice River (Herbert),46,13.29,300,86.71,346,99.14,3,0.86,349
1,QLD,167,Alice River (Kennedy),138,16.37,705,83.63,843,99.76,2,0.24,845
1,QLD,157,Allenstown,531,32.52,1102,67.48,1633,99.15,14,0.85,1647
1,QLD,157,Alligator Creek,98,14.22,591,85.78,689,99.42,4,0.58,693
1,QLD,170,Allora,140,17.37,666,82.63,806,98.9,9,1.1,815
1,QLD,166,Alloway,50,15.63,270,84.38,320,99.38,2,0.62,322
1,QLD,167,Aloomba,52,17.22,250,82.78,302,99.67,1,0.33,303
1,QLD,170,Alpha,24,12.57,167,87.43,191,100,0,0,191
1,QLD,311,Alton Downs,31,7.47,384,92.53,415,99.52,2,0.48,417
1,QLD,178,Amamoor,83,20.29,326,79.71,409,99.51,2,0.49,411
1,QLD,170,Amiens,13,13.4,84,86.6,97,100,0,0,97
1,QLD,155,Amity Point,66,30.14,153,69.86,219,99.55,1,0.45,220
1,QLD,158,Andergrove,288,22.71,980,77.29,1268,99.22,10,0.78,1278
1,QLD,158,Andergrove South,437,25.06,1307,74.94,1744,99.03,17,0.97,1761
1,QLD,158,Annandale (Dawson),379,30.42,867,69.58,1246,99.05,12,0.95,1258
1,QLD,165,Annandale (Herbert),126,30.22,291,69.78,417,99.05,4,0.95,421
1,QLD,158,Annandale East (Dawson),249,30.18,576,69.82,825,99.4,5,0.6,830
1,QLD,165,Annandale East (Herbert),71,26.89,193,73.11,264,100,0,0,264
1,QLD,173,Annerley,400,63.49,230,36.51,630,98.75,8,1.25,638
1,QLD,173,Annerley Junction,650,65.92,336,34.08,986,98.6,14,1.4,1000
1,QLD,166,Apple Tree Creek,37,15.23,206,84.77,243,100,0,0,243
1,QLD,170,Applethorpe,35,16.99,171,83.01,206,98.56,3,1.44,209
1,QLD,170,Aramac,19,13.57,121,86.43,140,98.59,2,1.41,142
1,QLD,252,Arana Hills,552,53.75,475,46.25,1027,99.23,8,0.77,1035
1,QLD,316,Aratula,59,16.16,306,83.84,365,99.18,3,0.82,368
1,QLD,165,Arcadia,256,44.14,324,55.86,580,98.64,8,1.36,588
1,QLD,159,Arundel,1074,33.25,2156,66.75,3230,98.27,57,1.73,3287
1,QLD,159,Arundel East,310,38.04,505,61.96,815,98.55,12,1.45,827
1,QLD,156,Ascot,888,41.67,1243,58.33,2131,99.25,16,0.75,2147
1,QLD,156,Ashgrove,1088,63.55,624,36.45,1712,98.62,24,1.38,1736
1,QLD,156,Ashgrove West (Brisbane),591,62.81,350,37.19,941,99.58,4,0.42,945
1,QLD,177,Ashgrove West (Ryan),641,66.01,330,33.99,971,99.39,6,0.61,977
1,QLD,172,Ashmore,600,31.33,1315,68.67,1915,97.46,50,2.54,1965
1,QLD,172,Ashmore West,436,32.13,921,67.87,1357,98.69,18,1.31,1375
1,QLD,169,Aspley (Lilley),152,43.3,199,56.7,351,98.6,5,1.4,356
1,QLD,175,Aspley (Petrie),663,45.32,800,54.68,1463,98.92,16,1.08,1479
1,QLD,169,Aspley East (Lilley),466,50.76,452,49.24,918,99.03,9,0.97,927
1,QLD,175,Aspley East (Petrie),255,46.36,295,53.64,550,99.28,4,0.72,554
1,QLD,169,Aspley West,839,44.6,1042,55.4,1881,99.47,10,0.53,1891
1,QLD,167,Atherton,250,23.34,821,76.66,1071,98.98,11,1.02,1082
1,QLD,167,Atherton North,82,24.7,250,75.3,332,99.4,2,0.6,334
1,QLD,167,Atherton PPVC,1409,16.98,6890,83.02,8299,99.51,41,0.49,8340
1,QLD,177,Auchenflower,870,64.83,472,35.17,1342,99.33,9,0.67,1351
1,QLD,170,Augathella,25,13.97,154,86.03,179,98.35,3,1.65,182
1,QLD,174,Augustine Heights Central,570,41.18,814,58.82,1384,99.57,6,0.43,1390
1,QLD,166,Avoca,299,20.97,1127,79.03,1426,99.23,11,0.77,1437
1,QLD,158,Ayr,191,13.82,1191,86.18,1382,99.5,7,0.5,1389
1,QLD,158,Ayr East,49,21.78,176,78.22,225,97.83,5,2.17,230
1,QLD,158,Ayr PPVC,655,9.29,6398,90.71,7053,99.48,37,0.52,7090
1,QLD,167,Babinda,158,22.97,530,77.03,688,99.57,3,0.43,691
1,QLD,311,Baffle Creek,50,15.29,277,84.71,327,99.39,2,0.61,329
1,QLD,311,Bajool,15,8.98,152,91.02,167,100,0,0,167
1,QLD,157,Bakers Creek,97,19.52,400,80.48,497,99.4,3,0.6,500
1,QLD,175,Bald Hills,703,40.75,1022,59.25,1725,98.74,22,1.26,1747
1,QLD,170,Ballandean,51,25.37,150,74.63,201,100,0,0,201
1,QLD,163,Balmoral,770,57.98,558,42.02,1328,99.18,11,0.82,1339
1,QLD,168,Bamaga,263,60.05,175,39.95,438,99.32,3,0.68,441
1,QLD,311,Banana,17,10.83,140,89.17,157,100,0,0,157
1,QLD,302,Banksia Beach,365,28.45,918,71.55,1283,98.77,16,1.23,1299
1,QLD,169,Banyo East,1097,49.35,1126,50.65,2223,99.06,21,0.94,2244
1,QLD,311,Baralaba,17,8.54,182,91.46,199,100,0,0,199
1,QLD,170,Barcaldine,122,19.71,497,80.29,619,99.68,2,0.32,621
1,QLD,177,Bardon,671,63.54,385,36.46,1056,99.44,6,0.56,1062
1,QLD,166,Bargara,369,29.29,891,70.71,1260,98.9,14,1.1,1274
1,QLD,166,Bargara PPVC,1112,19.04,4729,80.96,5841,99.3,41,0.7,5882
1,QLD,166,Bargara South,269,28.32,681,71.68,950,98.96,10,1.04,960
1,QLD,161,Baringa,807,37.26,1359,62.74,2166,98.63,30,1.37,2196
1,QLD,178,Bauple,101,22.39,350,77.61,451,99.34,3,0.66,454
1,QLD,155,Bay View Thornlands,633,33.74,1243,66.26,1876,99.21,15,0.79,1891
1,QLD,168,Bayview Heights,234,30.12,543,69.88,777,98.23,14,1.77,791
1,QLD,302,Beachmere,399,24.92,1202,75.08,1601,98.83,19,1.17,1620
1,QLD,158,Beaconsfield,303,24.09,955,75.91,1258,99.29,9,0.71,1267
1,QLD,316,Beaudesert,192,20.43,748,79.57,940,99.26,7,0.74,947
1,QLD,316,Beaudesert East,258,26.52,715,73.48,973,98.88,11,1.12,984
1,QLD,316,Beaudesert PPVC,982,17.98,4481,82.02,5463,99.29,39,0.71,5502
1,QLD,316,Beechmont,257,47.42,285,52.58,542,98.01,11,1.99,553
1,QLD,162,Beenleigh,630,33.56,1247,66.44,1877,98.79,23,1.21,1900
1,QLD,159,Beenleigh FADDEN PPVC,139,21.75,500,78.25,639,99.53,3,0.47,642
1,QLD,162,Beenleigh FORDE PPVC,3167,24.31,9860,75.69,13027,99.11,117,0.89,13144
1,QLD,162,Beenleigh Voting Day PPVC,0,0,0,0,0,0,0,0, -   
1,QLD,316,Beenleigh WRIGHT PPVC,170,21.36,626,78.64,796,99.5,4,0.5,800
1,QLD,161,Beerburrum,64,22.54,220,77.46,284,99.3,2,0.7,286
1,QLD,161,Beerwah,442,25.7,1278,74.3,1720,98.57,25,1.43,1745
1,QLD,161,Beerwah PPVC,1636,24.26,5108,75.74,6744,99.06,64,0.94,6808
1,QLD,165,Belgian Gardens,479,43.59,620,56.41,1099,99.1,10,0.9,1109
1,QLD,170,Bell,26,9,263,91,289,99.66,1,0.34,290
1,QLD,302,Bellara,222,29.21,538,70.79,760,98.7,10,1.3,770
1,QLD,174,Bellbird Park,650,43.92,830,56.08,1480,98.67,20,1.33,1500
1,QLD,177,Bellbowrie,512,47.02,577,52.98,1089,99.63,4,0.37,1093
1,QLD,304,Bellbowrie BLAIR PPVC,254,37.97,415,62.03,669,99.11,6,0.89,675
1,QLD,177,Bellbowrie RYAN PPVC,1909,37.36,3201,62.64,5110,99.63,19,0.37,5129
1,QLD,172,Bellevue Park,478,39.5,732,60.5,1210,99.18,10,0.82,1220
1,QLD,302,Bellmere,354,29.92,829,70.08,1183,98.34,20,1.66,1203
1,QLD,310,Belmont,1030,44.24,1298,55.76,2328,99.19,19,0.81,2347
1,QLD,310,Belmont East,161,41.71,225,58.29,386,100,0,0,386
1,QLD,311,Benaraby,58,14.32,347,85.68,405,99.51,2,0.49,407
1,QLD,172,Benowa,779,33.38,1555,66.62,2334,98.61,33,1.39,2367
1,QLD,167,Bentley Park (Kennedy),267,27.13,717,72.87,984,98.11,19,1.89,1003
1,QLD,168,Bentley Park (Leichhardt),150,34.72,282,65.28,432,98.63,6,1.37,438
1,QLD,176,Berrinba East,560,38.78,884,61.22,1444,98.57,21,1.43,1465
1,QLD,157,Berserker,294,23.94,934,76.06,1228,98.95,13,1.05,1241
1,QLD,162,Bethania,656,32.69,1351,67.31,2007,98.24,36,1.76,2043
1,QLD,167,Biboohra,11,10.38,95,89.62,106,97.25,3,2.75,109
1,QLD,164,Biddeston,29,12.34,206,87.66,235,99.16,2,0.84,237
1,QLD,311,Biggenden,94,15.16,526,84.84,620,99.52,3,0.48,623
1,QLD,159,Biggera Waters,397,34.58,751,65.42,1148,97.95,24,2.05,1172
1,QLD,311,Biloela,134,18.21,602,81.79,736,98.79,9,1.21,745
1,QLD,311,Biloela PPVC,368,10.65,3087,89.35,3455,99.63,13,0.37,3468
1,QLD,155,Birkdale,815,35.42,1486,64.58,2301,99.44,13,0.56,2314
1,QLD,310,Birkdale BONNER PPVC,135,24.46,417,75.54,552,99.46,3,0.54,555
1,QLD,155,Birkdale BOWMAN PPVC,2584,24.93,7779,75.07,10363,99.16,88,0.84,10451
1,QLD,155,Birkdale South,586,32.5,1217,67.5,1803,98.96,19,1.04,1822
1,QLD,170,Blackall,90,14.4,535,85.6,625,99.52,3,0.48,628
1,QLD,170,Blackbutt,184,18.57,807,81.43,991,99,10,1,1001
1,QLD,311,Blackwater,136,17.17,656,82.83,792,99.25,6,0.75,798
1,QLD,311,Blackwater PPVC,130,10.07,1161,89.93,1291,99.69,4,0.31,1295
1,QLD,316,Blenheim,57,15.79,304,84.21,361,99.72,1,0.28,362
1,QLD,160,Bli Bli,697,34.82,1305,65.18,2002,98.57,29,1.43,2031
1,QLD,160,Bli Bli North,133,36.24,234,63.76,367,99.19,3,0.81,370
1,QLD,168,Bloomfield,139,66.51,70,33.49,209,99.52,1,0.48,210
1,QLD,158,Bloomsbury,46,13.61,292,86.39,338,99.41,2,0.59,340
1,QLD,165,Bluewater,181,16.34,927,83.66,1108,99.37,7,0.63,1115
1,QLD,311,Bluff,15,11.36,117,88.64,132,99.25,1,0.75,133
1,QLD,161,Bokarina,446,40.55,654,59.45,1100,98.57,16,1.43,1116
1,QLD,170,Bollon,6,7.14,78,92.86,84,100,0,0,84
1,QLD,302,Bongaree,398,29.29,961,70.71,1359,98.91,15,1.09,1374
1,QLD,171,Bonogin (McPherson),100,34.84,187,65.16,287,97.95,6,2.05,293
1,QLD,316,Bonogin (Wright),350,31.76,752,68.24,1102,99.46,6,0.54,1108
1,QLD,316,Boonah,203,25.66,588,74.34,791,99.25,6,0.75,797
1,QLD,316,Boonah PPVC,509,18.24,2281,81.76,2790,99.11,25,0.89,2815
1,QLD,169,Boondall,417,47.88,454,52.12,871,98.86,10,1.14,881
1,QLD,169,Boondall LILLEY PPVC,3485,38.3,5615,61.7,9100,99.32,62,0.68,9162
1,QLD,175,Boondall PETRIE PPVC,953,33.94,1855,66.06,2808,99.36,18,0.64,2826
1,QLD,178,Boonooroo,38,12.06,277,87.94,315,100,0,0,315
1,QLD,178,Boreen Point,162,41.54,228,58.46,390,98.73,5,1.27,395
1,QLD,162,Boronia Heights (Forde),459,30.4,1051,69.6,1510,98.5,23,1.5,1533
1,QLD,176,Boronia Heights (Rankin),141,32.71,290,67.29,431,99.08,4,0.92,435
1,QLD,311,Bouldercombe,54,14.44,320,85.56,374,99.2,3,0.8,377
1,QLD,167,Boulia,22,20,88,80,110,100,0,0,110
1,QLD,158,Bowen,243,20.68,932,79.32,1175,99.07,11,0.93,1186
1,QLD,158,Bowen PPVC,597,14.34,3566,85.66,4163,99.52,20,0.48,4183
1,QLD,164,Bowenville,10,8.2,112,91.8,122,100,0,0,122
1,QLD,311,Boyne Island,336,23.01,1124,76.99,1460,99.05,14,0.95,1474
1,QLD,311,Boyne Tannum PPVC,771,22.84,2605,77.16,3376,99.5,17,0.5,3393
1,QLD,311,Boyne Valley,23,17.04,112,82.96,135,99.26,1,0.74,136
1,QLD,175,Bracken Ridge,426,36.22,750,63.78,1176,98.91,13,1.09,1189
1,QLD,175,Bracken Ridge East,743,42.29,1014,57.71,1757,98.99,18,1.01,1775
1,QLD,175,Bracken Ridge South,328,42.65,441,57.35,769,98.97,8,1.03,777
1,QLD,175,Bracken Ridge West,801,39.89,1207,60.11,2008,99.11,18,0.89,2026
1,QLD,166,Branyan,204,18.98,871,81.02,1075,98.9,12,1.1,1087
1,QLD,304,Brassall,557,32.42,1161,67.58,1718,98.85,20,1.15,1738
1,QLD,304,Brassall North,581,32.33,1216,67.67,1797,98.68,24,1.32,1821
1,QLD,252,Bray Park,590,35.1,1091,64.9,1681,98.48,26,1.52,1707
1,QLD,252,Bray Park West,1063,32.39,2219,67.61,3282,98.71,43,1.29,3325
1,QLD,302,Bribie Island PPVC,2647,21.38,9732,78.62,12379,99.4,75,0.6,12454
1,QLD,252,Bridgeman Downs (Dickson),280,43.48,364,56.52,644,99.23,5,0.77,649
1,QLD,175,Bridgeman Downs (Petrie),718,38.35,1154,61.65,1872,99.52,9,0.48,1881
1,QLD,169,Brighton,867,49.54,883,50.46,1750,99.43,10,0.57,1760
1,QLD,169,Brighton South,783,49.53,798,50.47,1581,99.12,14,0.88,1595
1,QLD,168,Brinsmead,427,37.03,726,62.97,1153,98.38,19,1.62,1172
1,QLD,310,Brisbane BONNER PPVC,61,47.66,67,52.34,128,99.22,1,0.78,129
1,QLD,156,Brisbane BRISBANE PPVC,2435,53.74,2096,46.26,4531,99.34,30,0.66,4561
1,QLD,310,Brisbane Central BONNER PPVC,876,49.91,879,50.09,1755,99.15,15,0.85,1770
1,QLD,156,Brisbane Central BRISBANE PPVC,6616,54.97,5419,45.03,12035,99.44,68,0.56,12103
1,QLD,252,Brisbane Central DICKSON PPVC,580,50.43,570,49.57,1150,98.63,16,1.37,1166
1,QLD,163,Brisbane Central GRIFFITH PPVC,3962,58.17,2849,41.83,6811,99.34,45,0.66,6856
1,QLD,169,Brisbane Central LILLEY PPVC,1469,56.57,1128,43.43,2597,99.16,22,0.84,2619
1,QLD,173,Brisbane Central MORETON PPVC,1570,55.87,1240,44.13,2810,98.84,33,1.16,2843
1,QLD,174,Brisbane Central OXLEY PPVC,625,52.21,572,47.79,1197,99.34,8,0.66,1205
1,QLD,175,Brisbane Central PETRIE PPVC,425,47.59,468,52.41,893,98.78,11,1.22,904
1,QLD,176,Brisbane Central RANKIN PPVC,439,46.41,507,53.59,946,99.16,8,0.84,954
1,QLD,177,Brisbane Central RYAN PPVC,2272,58.24,1629,41.76,3901,99.54,18,0.46,3919
1,QLD,163,Brisbane GRIFFITH PPVC,401,48.26,430,51.74,831,98.81,10,1.19,841
1,QLD,169,Brisbane LILLEY PPVC,135,56.02,106,43.98,241,100,0,0,241
1,QLD,173,Brisbane MORETON PPVC,131,61.79,81,38.21,212,99.53,1,0.47,213
1,QLD,310,Brisbane North (Bonner),60,62.5,36,37.5,96,98.97,1,1.03,97
1,QLD,156,Brisbane North (Brisbane),1336,60.51,872,39.49,2208,99.15,19,0.85,2227
1,QLD,252,Brisbane North (Dickson),34,52.31,31,47.69,65,97.01,2,2.99,67
1,QLD,163,Brisbane North (Griffith),443,65.73,231,34.27,674,99.12,6,0.88,680
1,QLD,169,Brisbane North (Lilley),96,62.75,57,37.25,153,99.35,1,0.65,154
1,QLD,173,Brisbane North (Moreton),145,64.73,79,35.27,224,98.25,4,1.75,228
1,QLD,174,Brisbane North (Oxley),56,54.9,46,45.1,102,99.03,1,0.97,103
1,QLD,175,Brisbane North (Petrie),41,50.62,40,49.38,81,98.78,1,1.22,82
1,QLD,176,Brisbane North (Rankin),46,56.1,36,43.9,82,100,0,0,82
1,QLD,177,Brisbane North (Ryan),213,65.54,112,34.46,325,99.09,3,0.91,328
1,QLD,177,Brisbane RYAN PPVC,213,54.76,176,45.24,389,99.74,1,0.26,390
1,QLD,172,Broadbeach,688,38.18,1114,61.82,1802,98.79,22,1.21,1824
1,QLD,172,Broadbeach Waters,431,35.18,794,64.82,1225,98.16,23,1.84,1248
1,QLD,171,Broadbeach Waters MCPHERSON PPVC,380,27.08,1023,72.92,1403,98.87,16,1.13,1419
1,QLD,172,Broadbeach Waters MONCRIEFF PPVC,1879,26.68,5165,73.32,7044,99.09,65,0.91,7109
1,QLD,172,Broadbeach Waters West,182,33.27,365,66.73,547,98.38,9,1.62,556
1,QLD,170,Broadwater Crossing,36,16.29,185,83.71,221,99.55,1,0.45,222
1,QLD,177,Brookfield,638,47.75,698,52.25,1336,99.63,5,0.37,1341
1,QLD,178,Brooweena,14,15.56,76,84.44,90,98.9,1,1.1,91
1,QLD,176,Browns Plains,710,37.02,1208,62.98,1918,98.21,35,1.79,1953
1,QLD,162,Browns Plains FORDE PPVC,905,22.45,3126,77.55,4031,99.07,38,0.93,4069
1,QLD,176,Browns Plains RANKIN PPVC,2763,27.21,7393,72.79,10156,99.02,100,0.98,10256
1,QLD,316,Browns Plains WRIGHT PPVC,435,20.92,1644,79.08,2079,98.86,24,1.14,2103
1,QLD,158,Bucasia,447,26.17,1261,73.83,1708,99.13,15,0.87,1723
1,QLD,161,Buddina,683,35.83,1223,64.17,1906,98.5,29,1.5,1935
1,QLD,160,Buddina FAIRFAX PPVC,542,32.55,1123,67.45,1665,98.99,17,1.01,1682
1,QLD,161,Buddina FISHER PPVC,2313,25.65,6704,74.35,9017,99.14,78,0.86,9095
1,QLD,160,Buderim,794,43.67,1024,56.33,1818,99.07,17,0.93,1835
1,QLD,160,Buderim FAIRFAX PPVC,3303,33.93,6432,66.07,9735,99.41,58,0.59,9793
1,QLD,161,Buderim FISHER PPVC,767,30.16,1776,69.84,2543,99.22,20,0.78,2563
1,QLD,160,Buderim North,323,36.91,552,63.09,875,99.09,8,0.91,883
1,QLD,160,Buderim South,350,39.59,534,60.41,884,99.21,7,0.79,891
1,QLD,160,Buderim South FAIRFAX PPVC,1363,33.37,2722,66.63,4085,99.32,28,0.68,4113
1,QLD,161,Buderim South FISHER PPVC,787,29.99,1837,70.01,2624,99.02,26,0.98,2650
1,QLD,160,Buderim West,459,45.67,546,54.33,1005,98.53,15,1.47,1020
1,QLD,163,Bulimba,1140,49.83,1148,50.17,2288,99.09,21,0.91,2309
1,QLD,163,Bulimba Heights,687,57.3,512,42.7,1199,99.67,4,0.33,1203
1,QLD,311,Bullyard,56,14.18,339,85.82,395,99.5,2,0.5,397
1,QLD,166,Bundaberg Central,276,23.88,880,76.12,1156,98.72,15,1.28,1171
1,QLD,311,Bundaberg Central FLYNN PPVC,310,14.21,1871,85.79,2181,99.82,4,0.18,2185
1,QLD,166,Bundaberg Central HINKLER PPVC,1842,17.01,8988,82.99,10830,99.49,56,0.51,10886
1,QLD,166,Bundaberg East,262,20.61,1009,79.39,1271,98.91,14,1.09,1285
1,QLD,311,Bundaberg FLYNN PPVC,246,14.33,1471,85.67,1717,99.88,2,0.12,1719
1,QLD,166,Bundaberg HINKLER PPVC,1527,16.62,7661,83.38,9188,99.44,52,0.56,9240
1,QLD,166,Bundaberg North,173,21.95,615,78.05,788,98.5,12,1.5,800
1,QLD,311,Bundaberg North West (Flynn),61,15.93,322,84.07,383,98.21,7,1.79,390
1,QLD,166,Bundaberg North West (Hinkler),134,19.91,539,80.09,673,98.83,8,1.17,681
1,QLD,166,Bundaberg South,204,26.02,580,73.98,784,99.75,2,0.25,786
1,QLD,166,Bundaberg West,257,29.54,613,70.46,870,98.75,11,1.25,881
1,QLD,172,Bundall,367,32.14,775,67.86,1142,97.52,29,2.48,1171
1,QLD,304,Bundamba,364,34.77,683,65.23,1047,99.05,10,0.95,1057
1,QLD,304,Bundamba South,539,34.14,1040,65.86,1579,98.69,21,1.31,1600
1,QLD,252,Bunya DICKSON PPVC,3137,35.2,5774,64.8,8911,99.4,54,0.6,8965
1,QLD,169,Bunya LILLEY PPVC,320,38.37,514,61.63,834,99.05,8,0.95,842
1,QLD,177,Bunya RYAN PPVC,659,39.51,1009,60.49,1668,99.64,6,0.36,1674
1,QLD,163,Buranda West (Griffith),326,69.51,143,30.49,469,99.79,1,0.21,470
1,QLD,173,Buranda West (Moreton),183,68.03,86,31.97,269,98.53,4,1.47,273
1,QLD,165,Burdell,309,19.24,1297,80.76,1606,99.26,12,0.74,1618
1,QLD,171,Burleigh Heads (McPherson),747,46.57,857,53.43,1604,97.98,33,2.02,1637
1,QLD,172,Burleigh Heads (Moncrieff),111,45.31,134,54.69,245,98.79,3,1.21,248
1,QLD,171,Burleigh Heads MCPHERSON PPVC,4525,30.75,10190,69.25,14715,98.84,172,1.16,14887
1,QLD,172,Burleigh Heads MONCRIEFF PPVC,1415,32.19,2981,67.81,4396,98.9,49,1.1,4445
1,QLD,171,Burleigh North (McPherson),117,38.36,188,61.64,305,98.39,5,1.61,310
1,QLD,172,Burleigh North (Moncrieff),99,45.21,120,54.79,219,98.21,4,1.79,223
1,QLD,171,Burleigh Waters,872,42.41,1184,57.59,2056,98.56,30,1.44,2086
1,QLD,166,Burnett Heads,214,21.42,785,78.58,999,99.3,7,0.7,1006
1,QLD,160,Burnside,504,35.22,927,64.78,1431,98.96,15,1.04,1446
1,QLD,302,Burpengary,245,24.7,747,75.3,992,99,10,1,1002
1,QLD,302,Burpengary East (Longman),208,28.3,527,71.7,735,99.06,7,0.94,742
1,QLD,175,Burpengary East (Petrie),155,28.08,397,71.92,552,99.28,4,0.72,556
1,QLD,302,Burpengary LONGMAN PPVC,1872,21.78,6725,78.22,8597,99.41,51,0.59,8648
1,QLD,302,Burpengary Meadows,463,26.32,1296,73.68,1759,98.99,18,1.01,1777
1,QLD,175,Burpengary PETRIE PPVC,261,20.85,991,79.15,1252,99.6,5,0.4,1257
1,QLD,302,Burpengary South,287,28.08,735,71.92,1022,97.99,21,2.01,1043
1,QLD,302,Burpengary West,464,28.09,1188,71.91,1652,98.8,20,1.2,1672
1,QLD,176,Burrowes,868,39.19,1347,60.81,2215,98.14,42,1.86,2257
1,QLD,166,Burrum Heads,164,14.11,998,85.89,1162,99.57,5,0.43,1167
1,QLD,302,Caboolture,434,31.68,936,68.32,1370,98.7,18,1.3,1388
1,QLD,302,Caboolture East,462,31.39,1010,68.61,1472,98.79,18,1.21,1490
1,QLD,302,Caboolture North,492,25.81,1414,74.19,1906,98.25,34,1.75,1940
1,QLD,302,Caboolture PPVC,1960,22.45,6769,77.55,8729,99.27,64,0.73,8793
1,QLD,302,Caboolture West,367,23.02,1227,76.98,1594,98.4,26,1.6,1620
1,QLD,167,Cairns CBD KENNEDY PPVC,232,29.11,565,70.89,797,98.52,12,1.48,809
1,QLD,168,Cairns CBD LEICHHARDT PPVC,2880,34.67,5427,65.33,8307,99.4,50,0.6,8357
1,QLD,168,Cairns City,576,46.08,674,53.92,1250,99.05,12,0.95,1262
1,QLD,167,Cairns KENNEDY PPVC,127,26.79,347,73.21,474,99.37,3,0.63,477
1,QLD,168,Cairns LEICHHARDT PPVC,2735,31.05,6073,68.95,8808,99.26,66,0.74,8874
1,QLD,167,Cairns South KENNEDY PPVC,1693,19.31,7075,80.69,8768,99.47,47,0.53,8815
1,QLD,168,Cairns South LEICHHARDT PPVC,1602,21.15,5974,78.85,7576,99.44,43,0.56,7619
1,QLD,168,Cairns West,554,46.63,634,53.37,1188,99,12,1,1200
1,QLD,176,Calamvale,925,44.39,1159,55.61,2084,99.29,15,0.71,2099
1,QLD,176,Calamvale East,545,45.99,640,54.01,1185,99.33,8,0.67,1193
1,QLD,158,Calen,58,12.29,414,87.71,472,99.79,1,0.21,473
1,QLD,311,Calliope,261,15.48,1425,84.52,1686,98.54,25,1.46,1711
1,QLD,161,Caloundra,749,38.23,1210,61.77,1959,98.49,30,1.51,1989
1,QLD,161,Caloundra East PPVC,4507,27,12187,73,16694,99.09,153,0.91,16847
1,QLD,161,Caloundra West,394,31.49,857,68.51,1251,98.89,14,1.11,1265
1,QLD,161,Caloundra West PPVC,1341,28.96,3290,71.04,4631,98.87,53,1.13,4684
1,QLD,164,Cambooya,137,15.66,738,84.34,875,99.09,8,0.91,883
1,QLD,174,Camira,663,33.07,1342,66.93,2005,98.57,29,1.43,2034
1,QLD,163,Camp Hill,1197,57.05,901,42.95,2098,98.78,26,1.22,2124
1,QLD,163,Cannon Hill,1103,57.15,827,42.85,1930,99.08,18,0.92,1948
1,QLD,163,Cannon Hill Central,432,57.75,316,42.25,748,99.2,6,0.8,754
1,QLD,158,Cannonvale,392,32.48,815,67.52,1207,98.85,14,1.15,1221
1,QLD,159,Canowindra (Fadden),230,25,690,75,920,98.82,11,1.18,931
1,QLD,162,Canowindra (Forde),222,27.41,588,72.59,810,99.63,3,0.37,813
1,QLD,316,Canungra,357,26.44,993,73.56,1350,98.83,16,1.17,1366
1,QLD,155,Capalaba,471,31.21,1038,68.79,1509,98.31,26,1.69,1535
1,QLD,155,Capalaba West,452,32.47,940,67.53,1392,98.51,21,1.49,1413
1,QLD,311,Capella,47,12.21,338,87.79,385,99.74,1,0.26,386
1,QLD,168,Caravonica,524,33.16,1056,66.84,1580,99,16,1,1596
1,QLD,162,Carbrook,165,27.36,438,72.64,603,98.21,11,1.79,614
1,QLD,167,Cardwell,107,16.61,537,83.39,644,99.69,2,0.31,646
1,QLD,163,Carina,827,57.83,603,42.17,1430,99.37,9,0.63,1439
1,QLD,163,Carina Heights,614,52.79,549,47.21,1163,98.89,13,1.11,1176
1,QLD,310,Carina Heights BONNER PPVC,2046,36.91,3497,63.09,5543,99.44,31,0.56,5574
1,QLD,163,Carina Heights GRIFFITH PPVC,6001,46.86,6805,53.14,12806,99.38,80,0.62,12886
1,QLD,173,Carina Heights MORETON PPVC,338,51.37,320,48.63,658,98.5,10,1.5,668
1,QLD,310,Carindale (Bonner),753,46.83,855,53.17,1608,99.01,16,0.99,1624
1,QLD,163,Carindale (Griffith),467,52.95,415,47.05,882,98.99,9,1.01,891
1,QLD,174,Carole Park,237,34,460,66,697,97.76,16,2.24,713
1,QLD,172,Carrara,683,34.95,1271,65.05,1954,98.69,26,1.31,1980
1,QLD,159,Carrara FADDEN PPVC,114,26.89,310,73.11,424,98.83,5,1.17,429
1,QLD,171,Carrara MCPHERSON PPVC,379,24.67,1157,75.33,1536,99.1,14,0.9,1550
1,QLD,172,Carrara MONCRIEFF PPVC,2620,23.86,8361,76.14,10981,99.12,97,0.88,11078
1,QLD,316,Carrara WRIGHT PPVC,469,22.84,1584,77.16,2053,99.27,15,0.73,2068
1,QLD,157,Cawarral,80,15.75,428,84.25,508,100,0,0,508
1,QLD,170,Cecil Plains,19,10.16,168,89.84,187,97.91,4,2.09,191
1,QLD,162,Cedar Creek,56,25.69,162,74.31,218,99.54,1,0.46,219
1,QLD,164,Centenary Heights North,685,36.09,1213,63.91,1898,99.16,16,0.84,1914
1,QLD,164,Centenary Heights South,117,31.03,260,68.97,377,99.21,3,0.79,380
1,QLD,177,Chapel Hill,1047,53.83,898,46.17,1945,99.34,13,0.66,1958
1,QLD,177,Chapel Hill South,716,57.42,531,42.58,1247,99.28,9,0.72,1256
1,QLD,170,Charleville,143,28.66,356,71.34,499,98.23,9,1.77,508
1,QLD,170,Charleville PPVC,192,16.33,984,83.67,1176,99.24,9,0.76,1185
1,QLD,167,Charters Towers,121,14.47,715,85.53,836,99.17,7,0.83,843
1,QLD,167,Charters Towers Central,76,19.39,316,80.61,392,98.99,4,1.01,396
1,QLD,167,Charters Towers PPVC,332,9.91,3017,90.09,3349,99.52,16,0.48,3365
1,QLD,176,Chatswood Hills,478,41.21,682,58.79,1160,98.47,18,1.53,1178
1,QLD,178,Chatsworth,120,18.99,512,81.01,632,98.29,11,1.71,643
1,QLD,173,Chelmer,431,59.45,294,40.55,725,99.72,2,0.28,727
1,QLD,157,Chelona,35,9.78,323,90.22,358,98.9,4,1.1,362
1,QLD,178,Cherbourg,142,58.44,101,41.56,243,99.59,1,0.41,244
1,QLD,169,Chermside East,964,51.36,913,48.64,1877,99,19,1,1896
1,QLD,169,Chermside North,362,51.2,345,48.8,707,99.3,5,0.7,712
1,QLD,169,Chermside South,535,51.49,504,48.51,1039,98.3,18,1.7,1057
1,QLD,169,Chermside West,904,49.75,913,50.25,1817,98.97,19,1.03,1836
1,QLD,166,Childers,109,16.9,536,83.1,645,99.23,5,0.77,650
1,QLD,166,Childers PPVC,407,13.87,2528,86.13,2935,99.36,19,0.64,2954
1,QLD,167,Chillagoe,24,21.24,89,78.76,113,96.58,4,3.42,117
1,QLD,170,Chinchilla,146,14.01,896,85.99,1042,99.33,7,0.67,1049
1,QLD,170,Chinchilla North,56,12.17,404,87.83,460,99.35,3,0.65,463
1,QLD,170,Chinchilla PPVC,365,13.36,2368,86.64,2733,99.42,16,0.58,2749
1,QLD,304,Churchill,217,28.52,544,71.48,761,98.32,13,1.68,774
1,QLD,156,Clayfield Central,541,52.27,494,47.73,1035,98.95,11,1.05,1046
1,QLD,156,Clayfield East,654,55.47,525,44.53,1179,99.24,9,0.76,1188
1,QLD,156,Clayfield West,895,55.08,730,44.92,1625,99.39,10,0.61,1635
1,QLD,157,Clermont,53,10.39,457,89.61,510,99.61,2,0.39,512
1,QLD,157,Clermont PPVC,83,8.3,917,91.7,1000,99.4,6,0.6,1006
1,QLD,155,Cleveland,537,32.7,1105,67.3,1642,99.21,13,0.79,1655
1,QLD,155,Cleveland Central,601,32.42,1253,67.58,1854,98.72,24,1.28,1878
1,QLD,155,Cleveland PPVC,4612,24.21,14439,75.79,19051,99.33,129,0.67,19180
1,QLD,170,Clifton,126,13.55,804,86.45,930,99.15,8,0.85,938
1,QLD,168,Clifton Beach,334,31.48,727,68.52,1061,98.97,11,1.03,1072
1,QLD,311,Clinton North,194,23.8,621,76.2,815,99.63,3,0.37,818
1,QLD,311,Clinton South,291,22.4,1008,77.6,1299,98.63,18,1.37,1317
1,QLD,167,Cloncurry,165,23.95,524,76.05,689,99.71,2,0.29,691
1,QLD,175,Clontarf,488,37.17,825,62.83,1313,99.02,13,0.98,1326
1,QLD,175,Clontarf Beach,278,36.34,487,63.66,765,99.61,3,0.39,768
1,QLD,252,Closeburn,281,41.69,393,58.31,674,99.26,5,0.74,679
1,QLD,178,Cloyna,15,6.07,232,93.93,247,99.2,2,0.8,249
1,QLD,168,Coen,60,52.17,55,47.83,115,98.29,2,1.71,117
1,QLD,304,Collingwood Park (Blair),186,28.88,458,71.12,644,98.92,7,1.08,651
1,QLD,174,Collingwood Park (Oxley),372,40.57,545,59.43,917,98.71,12,1.29,929
1,QLD,304,Collingwood Park South,369,39.81,558,60.19,927,99.14,8,0.86,935
1,QLD,157,Collinsville,98,14,602,86,700,99.72,2,0.28,702
1,QLD,170,Condamine,15,6.58,213,93.42,228,100,0,0,228
1,QLD,165,Condon,338,22.73,1149,77.27,1487,99.33,10,0.67,1497
1,QLD,158,Coningsby,85,14.05,520,85.95,605,99.67,2,0.33,607
1,QLD,161,Conondale,94,37.3,158,62.7,252,98.82,3,1.18,255
1,QLD,155,Coochiemudlo Island,184,42.89,245,57.11,429,100,0,0,429
1,QLD,168,Cooktown,170,32.32,356,67.68,526,99.43,3,0.57,529
1,QLD,168,Cooktown PPVC,221,25.64,641,74.36,862,99.19,7,0.81,869
1,QLD,170,Coolabunia,42,26.42,117,73.58,159,99.38,1,0.63,160
1,QLD,171,Coolangatta,228,37.32,383,62.68,611,98.55,9,1.45,620
1,QLD,155,Coolnwynpin,608,34.94,1132,65.06,1740,98.98,18,1.02,1758
1,QLD,178,Cooloola Cove,213,16.65,1066,83.35,1279,98.99,13,1.01,1292
1,QLD,160,Coolum Beach,825,48.42,879,51.58,1704,98.33,29,1.67,1733
1,QLD,160,Coolum Beach FAIRFAX PPVC,4010,36.9,6856,63.1,10866,99.16,92,0.84,10958
1,QLD,160,Coolum Beach North,829,47.64,911,52.36,1740,98.64,24,1.36,1764
1,QLD,178,Coolum Beach WIDE BAY PPVC,738,43.93,942,56.07,1680,98.88,19,1.12,1699
1,QLD,159,Coombabah,213,26.13,602,73.87,815,98.43,13,1.57,828
1,QLD,159,Coombabah South,307,35.13,567,64.87,874,98.53,13,1.47,887
1,QLD,159,Coomera,255,29.51,609,70.49,864,98.63,12,1.37,876
1,QLD,159,Coomera East,503,34.08,973,65.92,1476,98.4,24,1.6,1500
1,QLD,159,Coomera North,701,30.94,1565,69.06,2266,98.87,26,1.13,2292
1,QLD,162,Coomera Springs,536,32.25,1126,67.75,1662,98.99,17,1.01,1679
1,QLD,304,Coominya,118,18.58,517,81.42,635,99.53,3,0.47,638
1,QLD,173,Coopers Plains,588,48.55,623,51.45,1211,98.06,24,1.94,1235
1,QLD,310,Coopers Plains BONNER PPVC,138,40.95,199,59.05,337,100,0,0,337
1,QLD,173,Coopers Plains MORETON PPVC,4506,38.81,7105,61.19,11611,99.32,79,0.68,11690
1,QLD,174,Coopers Plains OXLEY PPVC,138,39.09,215,60.91,353,97.78,8,2.22,361
1,QLD,176,Coopers Plains RANKIN PPVC,753,32.7,1550,67.3,2303,98.93,25,1.07,2328
1,QLD,178,Cooran,397,44.31,499,55.69,896,98.9,10,1.1,906
1,QLD,178,Cooroy,425,34.86,794,65.14,1219,98.62,17,1.38,1236
1,QLD,178,Cooroy South,419,34.8,785,65.2,1204,98.69,16,1.31,1220
1,QLD,163,Coorparoo,1304,62.84,771,37.16,2075,99.09,19,0.91,2094
1,QLD,163,Coorparoo Central,1044,59.79,702,40.21,1746,98.87,20,1.13,1766
1,QLD,163,Coorparoo South,461,54.24,389,45.76,850,99.3,6,0.7,856
1,QLD,170,Cooyar,17,11.41,132,88.59,149,99.33,1,0.67,150
1,QLD,166,Cordalba,35,15.91,185,84.09,220,98.65,3,1.35,223
1,QLD,173,Corinda,740,56.7,565,43.3,1305,99.32,9,0.68,1314
1,QLD,173,Corinda South,591,58.46,420,41.54,1011,99.02,10,0.98,1021
1,QLD,162,Cornubia,569,29.67,1349,70.33,1918,99.07,18,0.93,1936
1,QLD,160,Cotton Tree,464,42.3,633,57.7,1097,98.21,20,1.79,1117
1,QLD,165,Cranbrook,340,30.69,768,69.31,1108,98.58,16,1.42,1124
1,QLD,176,Crestmead,512,31.9,1093,68.1,1605,98.41,26,1.59,1631
1,QLD,176,Crestmead South,226,30.38,518,69.62,744,99.6,3,0.4,747
1,QLD,170,Crows Nest,223,19.19,939,80.81,1162,99.4,7,0.6,1169
1,QLD,170,Cunnamulla,62,30.24,143,69.76,205,100,0,0,205
1,QLD,170,Cunnamulla PPVC,72,19.3,301,80.7,373,99.2,3,0.8,376
1,QLD,178,Curra,139,16.79,689,83.21,828,98.69,11,1.31,839
1,QLD,165,Currajong,364,29.55,868,70.45,1232,98.96,13,1.04,1245
1,QLD,161,Currimundi West,830,37.4,1389,62.6,2219,98.53,33,1.47,2252
1,QLD,171,Currumbin,598,45.65,712,54.35,1310,97.83,29,2.17,1339
1,QLD,171,Currumbin Valley,228,47.5,252,52.5,480,99.17,4,0.83,484
1,QLD,171,Currumbin Waters,730,40.42,1076,59.58,1806,98.26,32,1.74,1838
1,QLD,165,Cutheringa,374,44.47,467,55.53,841,99.29,6,0.71,847
1,QLD,168,Daintree,25,22.12,88,77.88,113,99.12,1,0.88,114
1,QLD,302,Dakabin,548,36.29,962,63.71,1510,98.37,25,1.63,1535
1,QLD,170,Dalby,183,17.78,846,82.22,1029,99.23,8,0.77,1037
1,QLD,170,Dalby North,134,17.45,634,82.55,768,98.97,8,1.03,776
1,QLD,170,Dalby PPVC,600,11.88,4449,88.12,5049,99.63,19,0.37,5068
1,QLD,170,Dalby South,114,16.06,596,83.94,710,99.3,5,0.7,715
1,QLD,170,Dalby West,94,13.22,617,86.78,711,99.3,5,0.7,716
1,QLD,170,Dalveen,23,15.54,125,84.46,148,100,0,0,148
1,QLD,164,Darling Heights,628,34.79,1177,65.21,1805,98.58,26,1.42,1831
1,QLD,174,Darra,546,43.68,704,56.32,1250,98.58,18,1.42,1268
1,QLD,252,Dayboro,617,34.82,1155,65.18,1772,99.16,15,0.84,1787
1,QLD,169,Deagon,361,45.01,441,54.99,802,99.26,6,0.74,808
1,QLD,175,Deception Bay,391,31.58,847,68.42,1238,98.57,18,1.43,1256
1,QLD,175,Deception Bay North,306,28.65,762,71.35,1068,98.07,21,1.93,1089
1,QLD,175,Deception Bay South,299,26.16,844,73.84,1143,98.28,20,1.72,1163
1,QLD,304,Deebing Heights,319,36.96,544,63.04,863,98.74,11,1.26,874
1,QLD,165,Deeragun,350,16.46,1776,83.54,2126,99.63,8,0.37,2134
1,QLD,161,Dicky Beach,815,42.05,1123,57.95,1938,98.18,36,1.82,1974
1,QLD,160,Diddillibah,326,33.71,641,66.29,967,99.18,8,0.82,975
1,QLD,167,Dimbulah,39,13,261,87,300,98.68,4,1.32,304
1,QLD,170,Dirranbandi,47,20.89,178,79.11,225,100,0,0,225
1,QLD,168,Diwan,80,29.96,187,70.04,267,97.45,7,2.55,274
1,QLD,302,Donnybrook,81,17.02,395,82.98,476,98.76,6,1.24,482
1,QLD,167,Doomadgee,267,66.58,134,33.42,401,99.26,3,0.74,404
1,QLD,156,Dorrington (Brisbane),401,66.39,203,33.61,604,99.51,3,0.49,607
1,QLD,177,Dorrington (Ryan),326,63.67,186,36.33,512,99.42,3,0.58,515
1,QLD,165,Douglas,395,49.56,402,50.44,797,99.5,4,0.5,801
1,QLD,164,Drayton,262,23.71,843,76.29,1105,98.84,13,1.16,1118
1,QLD,170,Dulacca,6,5,114,95,120,99.17,1,0.83,121
1,QLD,155,Dunwich,192,44.34,241,55.66,433,97.96,9,2.04,442
1,QLD,174,Durack,450,49.72,455,50.28,905,98.69,12,1.31,917
1,QLD,163,Dutton Park,679,69.22,302,30.78,981,99.19,8,0.81,989
1,QLD,157,Dysart,135,18.32,602,81.68,737,99.33,5,0.67,742
1,QLD,162,Eagleby,225,32.47,468,67.53,693,90.23,75,9.77,768
1,QLD,162,Eagleby South,539,32.61,1114,67.39,1653,98.45,26,1.55,1679
1,QLD,168,Earlville,462,29.56,1101,70.44,1563,99.18,13,0.82,1576
1,QLD,163,East Brisbane,1183,62.93,697,37.07,1880,99.16,16,0.84,1896
1,QLD,304,East Ipswich,443,36.82,760,63.18,1203,98.69,16,1.31,1219
1,QLD,167,East Palmerston,12,12.37,85,87.63,97,100,0,0,97
1,QLD,252,Eatons Hill,457,31.96,973,68.04,1430,99.03,14,0.97,1444
1,QLD,252,Eatons Hill West,781,39.66,1188,60.34,1969,99.04,19,0.96,1988
1,QLD,304,EAV Blair PPVC,0,0,0,0,0,0,0,0, -   
1,QLD,310,EAV Bonner PPVC,0,0,0,0,0,0,0,0, -   
1,QLD,155,EAV Bowman PPVC,0,0,0,0,0,0,0,0, -   
1,QLD,156,EAV Brisbane PPVC,0,0,0,0,0,0,0,0, -   
1,QLD,157,EAV Capricornia PPVC,0,0,0,0,0,0,0,0, -   
1,QLD,158,EAV Dawson PPVC,4,40,6,60,10,100,0,0,10
1,QLD,252,EAV Dickson PPVC,0,0,0,0,0,0,0,0, -   
1,QLD,159,EAV Fadden PPVC,0,0,0,0,0,0,0,0, -   
1,QLD,160,EAV Fairfax PPVC,1,20,4,80,5,100,0,0,5
1,QLD,161,EAV Fisher PPVC,0,0,0,0,0,0,0,0, -   
1,QLD,311,EAV Flynn PPVC,0,0,0,0,0,0,0,0, -   
1,QLD,162,EAV Forde PPVC,0,0,0,0,0,0,0,0, -   
1,QLD,163,EAV Griffith PPVC,0,0,0,0,0,0,0,0, -   
1,QLD,164,EAV Groom PPVC,4,36.36,7,63.64,11,100,0,0,11
1,QLD,165,EAV Herbert PPVC,3,33.33,6,66.67,9,100,0,0,9
1,QLD,166,EAV Hinkler PPVC,0,0,0,0,0,0,0,0, -   
1,QLD,167,EAV Kennedy PPVC,0,0,0,0,0,0,0,0, -   
1,QLD,168,EAV Leichhardt PPVC,0,0,0,0,0,0,0,0, -   
1,QLD,169,EAV Lilley PPVC,2,66.67,1,33.33,3,100,0,0,3
1,QLD,302,EAV Longman PPVC,0,0,0,0,0,0,0,0, -   
1,QLD,170,EAV Maranoa PPVC,5,33.33,10,66.67,15,100,0,0,15
1,QLD,171,EAV McPherson PPVC,0,0,0,0,0,0,0,0, -   
1,QLD,172,EAV Moncrieff PPVC,0,0,0,0,0,0,0,0, -   
1,QLD,173,EAV Moreton PPVC,0,0,0,0,0,0,0,0, -   
1,QLD,174,EAV Oxley PPVC,0,0,0,0,0,0,0,0, -   
1,QLD,175,EAV Petrie PPVC,5,55.56,4,44.44,9,100,0,0,9
1,QLD,176,EAV Rankin PPVC,0,0,0,0,0,0,0,0, -   
1,QLD,177,EAV Ryan PPVC,8,47.06,9,52.94,17,100,0,0,17
1,QLD,178,EAV Wide Bay PPVC,0,0,0,0,0,0,0,0, -   
1,QLD,316,EAV Wright PPVC,0,0,0,0,0,0,0,0, -   
1,QLD,162,Edens Landing,394,33,800,67,1194,98.43,19,1.57,1213
1,QLD,168,Edge Hill,995,43.72,1281,56.28,2276,98.66,31,1.34,2307
1,QLD,167,Edmonton (Kennedy),634,31.19,1399,68.81,2033,98.98,21,1.02,2054
1,QLD,168,Edmonton (Leichhardt),70,34.48,133,65.52,203,97.13,6,2.87,209
1,QLD,311,Eidsvold,64,24.81,194,75.19,258,100,0,0,258
1,QLD,173,Eight Mile Plains (Moreton),166,42.56,224,57.44,390,98.98,4,1.02,394
1,QLD,176,Eight Mile Plains (Rankin),407,41.87,565,58.13,972,98.38,16,1.62,988
1,QLD,158,Eimeo,666,24.04,2104,75.96,2770,99.14,24,0.86,2794
1,QLD,167,El Arish,74,21.45,271,78.55,345,98.57,5,1.43,350
1,QLD,171,Elanora,440,41.01,633,58.99,1073,98.71,14,1.29,1087
1,QLD,171,Elanora West,702,41.05,1008,58.95,1710,98.33,29,1.67,1739
1,QLD,302,Elimbah,270,21.5,986,78.5,1256,98.59,18,1.41,1274
1,QLD,166,Elliott Heads,111,22.98,372,77.02,483,99.38,3,0.62,486
1,QLD,311,Emerald,159,14.76,918,85.24,1077,99.72,3,0.28,1080
1,QLD,311,Emerald North,206,23.93,655,76.07,861,98.4,14,1.6,875
1,QLD,311,Emerald PPVC,615,12.18,4434,87.82,5049,99.55,23,0.45,5072
1,QLD,311,Emerald South,120,16.83,593,83.17,713,99.03,7,0.97,720
1,QLD,157,Emu Park,404,24.54,1242,75.46,1646,98.8,20,1.2,1666
1,QLD,156,Enoggera (Brisbane),403,55.89,318,44.11,721,99.04,7,0.96,728
1,QLD,177,Enoggera (Ryan),314,57.09,236,42.91,550,99.28,4,0.72,554
1,QLD,304,Esk,151,23.23,499,76.77,650,99.69,2,0.31,652
1,QLD,157,Eton,43,10.59,363,89.41,406,99.02,4,0.98,410
1,QLD,161,Eudlo,310,37.85,509,62.15,819,97.97,17,2.03,836
1,QLD,160,Eumundi,498,46.67,569,53.33,1067,98.8,13,1.2,1080
1,QLD,252,Everton Hills,551,48.46,586,51.54,1137,98.78,14,1.22,1151
1,QLD,169,Everton Park North,1046,55.08,853,44.92,1899,98.7,25,1.3,1924
1,QLD,173,Fairfield,621,62.41,374,37.59,995,98.81,12,1.19,1007
1,QLD,164,Fairview Heights,174,25.82,500,74.18,674,99.41,4,0.59,678
1,QLD,158,Farleigh,78,17.93,357,82.07,435,99.77,1,0.23,436
1,QLD,157,Farnborough,145,30.46,331,69.54,476,98.96,5,1.04,481
1,QLD,178,Federal,105,29.58,250,70.42,355,99.16,3,0.84,358
1,QLD,304,Fernvale,382,21.35,1407,78.65,1789,99.22,14,0.78,1803
1,QLD,177,Ferny Grove,1039,46.36,1202,53.64,2241,99.2,18,0.8,2259
1,QLD,252,Ferny Hills,627,55.83,496,44.17,1123,99.12,10,0.88,1133
1,QLD,252,Ferny Hills North,766,53.42,668,46.58,1434,98.83,17,1.17,1451
1,QLD,177,Fig Tree Pocket,769,49.61,781,50.39,1550,99.42,9,0.58,1559
1,QLD,157,Finch Hatton,69,15.51,376,84.49,445,99.11,4,0.89,449
1,QLD,175,Fitzgibbon,884,52,816,48,1700,99.13,15,0.87,1715
1,QLD,316,Flagstone,532,23.43,1739,76.57,2271,99.13,20,0.87,2291
1,QLD,316,Flagstone Creek,36,15.79,192,84.21,228,99.56,1,0.44,229
1,QLD,304,Flinders View,560,36.51,974,63.49,1534,98.9,17,1.1,1551
1,QLD,167,Flying Fish Point,35,36.08,62,63.92,97,98.98,1,1.02,98
1,QLD,160,Forest Glen,221,43.5,287,56.5,508,98.83,6,1.17,514
1,QLD,316,Forest Hill,92,18.7,400,81.3,492,98.99,5,1.01,497
1,QLD,174,Forest Lake,969,42.37,1318,57.63,2287,98.54,34,1.46,2321
1,QLD,174,Forest Lake Central,193,50.92,186,49.08,379,98.19,7,1.81,386
1,QLD,174,Forest Lake East,1021,46.18,1190,53.82,2211,99.01,22,0.99,2233
1,QLD,174,Forest Lake South,1004,41.96,1389,58.04,2393,99.38,15,0.62,2408
1,QLD,167,Forrest Beach,63,17.6,295,82.4,358,99.17,3,0.83,361
1,QLD,156,Fortitude Valley,472,61.86,291,38.14,763,99.22,6,0.78,769
1,QLD,157,Frenchville North,392,30.55,891,69.45,1283,98.77,16,1.23,1299
1,QLD,157,Frenchville South,428,27.07,1153,72.93,1581,98.57,23,1.43,1604
1,QLD,168,Freshwater,382,43.02,506,56.98,888,98.56,13,1.44,901
1,QLD,164,Gabbinbar,438,35.01,813,64.99,1251,99.52,6,0.48,1257
1,QLD,174,Gailes,313,35.61,566,64.39,879,98.32,15,1.68,894
1,QLD,165,Garbutt,263,28.19,670,71.81,933,99.04,9,0.96,942
1,QLD,167,Garradunga,19,14.39,113,85.61,132,100,0,0,132
1,QLD,316,Gatton,255,21.96,906,78.04,1161,98.64,16,1.36,1177
1,QLD,316,Gatton PPVC,900,13.3,5867,86.7,6767,99.24,52,0.76,6819
1,QLD,316,Gatton South,140,18.28,626,81.72,766,99.61,3,0.39,769
1,QLD,311,Gayndah,55,18.15,248,81.85,303,98.06,6,1.94,309
1,QLD,311,Gayndah PPVC,165,13.34,1072,86.66,1237,99.92,1,0.08,1238
1,QLD,177,Gaythorne,918,58.36,655,41.64,1573,99.12,14,0.88,1587
1,QLD,169,Geebung,636,52.78,569,47.22,1205,98.69,16,1.31,1221
1,QLD,156,Geebung BRISBANE PPVC,503,34.81,942,65.19,1445,99.11,13,0.89,1458
1,QLD,169,Geebung LILLEY PPVC,4331,40.58,6342,59.42,10673,99.31,74,0.69,10747
1,QLD,175,Geebung PETRIE PPVC,766,33.46,1523,66.54,2289,99.35,15,0.65,2304
1,QLD,164,Geham,126,22.95,423,77.05,549,99.82,1,0.18,550
1,QLD,167,Georgetown,12,8.82,124,91.18,136,99.27,1,0.73,137
1,QLD,316,Gilston,320,28.78,792,71.22,1112,99.11,10,0.89,1122
1,QLD,311,Gin Gin,179,14.61,1046,85.39,1225,99.35,8,0.65,1233
1,QLD,158,Giru,48,14.72,278,85.28,326,99.69,1,0.31,327
1,QLD,166,Givelda,19,14.29,114,85.71,133,100,0,0,133
1,QLD,311,Gladstone Central,401,25.02,1202,74.98,1603,98.95,17,1.05,1620
1,QLD,311,Gladstone PPVC,2668,17.36,12698,82.64,15366,99.81,29,0.19,15395
1,QLD,304,Glamorgan Vale,95,18.45,420,81.55,515,99.81,1,0.19,516
1,QLD,161,Glass House Mountains,348,29.82,819,70.18,1167,99.07,11,0.93,1178
1,QLD,170,Glen Aplin,38,22.62,130,77.38,168,99.41,1,0.59,169
1,QLD,158,Glenella,264,25.86,757,74.14,1021,98.84,12,1.16,1033
1,QLD,316,Glenore Grove,146,14.69,848,85.31,994,99.5,5,0.5,999
1,QLD,164,Glenvale,412,26.01,1172,73.99,1584,98.57,23,1.43,1607
1,QLD,161,Glenview,209,27.72,545,72.28,754,98.43,12,1.57,766
1,QLD,178,Glenwood,162,18.33,722,81.67,884,98.99,9,1.01,893
1,QLD,159,Gold Coast North FADDEN PPVC,1394,26.51,3865,73.49,5259,99.23,41,0.77,5300
1,QLD,162,Gold Coast North FORDE PPVC,1007,25.26,2979,74.74,3986,99.06,38,0.94,4024
1,QLD,161,Golden Beach,334,36.78,574,63.22,908,99.13,8,0.87,916
1,QLD,311,Gooburrum,70,12.73,480,87.27,550,99.28,4,0.72,554
1,QLD,174,Goodna,988,43.2,1299,56.8,2287,98.66,31,1.34,2318
1,QLD,166,Goodwood,26,24.3,81,75.7,107,100,0,0,107
1,QLD,178,Goomboorian,111,20.11,441,79.89,552,99.46,3,0.54,555
1,QLD,164,Goombungee,83,13.24,544,86.76,627,99.05,6,0.95,633
1,QLD,170,Goomburra,19,12.5,133,87.5,152,99.35,1,0.65,153
1,QLD,178,Goomeri,69,14.11,420,85.89,489,98.79,6,1.21,495
1,QLD,167,Goondi,224,21.15,835,78.85,1059,99.53,5,0.47,1064
1,QLD,170,Goondiwindi,65,15.48,355,84.52,420,100,0,0,420
1,QLD,170,Goondiwindi PPVC,209,8.61,2219,91.39,2428,99.47,13,0.53,2441
1,QLD,170,Goondiwindi West,130,14.76,751,85.24,881,98.77,11,1.23,892
1,QLD,156,Gordon Park,829,63.28,481,36.72,1310,99.09,12,0.91,1322
1,QLD,167,Gordonvale,455,24,1441,76,1896,98.44,30,1.56,1926
1,QLD,164,Gowrie,175,18.86,753,81.14,928,99.46,5,0.54,933
1,QLD,311,Gracemere,205,17.49,967,82.51,1172,99.41,7,0.59,1179
1,QLD,311,Gracemere PPVC,381,11.72,2870,88.28,3251,99.36,21,0.64,3272
1,QLD,311,Gracemere South,247,18.11,1117,81.89,1364,98.77,17,1.23,1381
1,QLD,173,Graceville,885,54.97,725,45.03,1610,99.44,9,0.56,1619
1,QLD,173,Graceville West,491,50.41,483,49.59,974,99.19,8,0.81,982
1,QLD,304,Grandchester,55,19.3,230,80.7,285,99.3,2,0.7,287
1,QLD,156,Grange,1441,64.85,781,35.15,2222,98.8,27,1.2,2249
1,QLD,316,Grantham,70,18.09,317,81.91,387,98.72,5,1.28,392
1,QLD,178,Granville,121,18.14,546,81.86,667,99.11,6,0.89,673
1,QLD,316,Greenbank,524,25.18,1557,74.82,2081,98.77,26,1.23,2107
1,QLD,316,Greenbank South,504,24.61,1544,75.39,2048,98.84,24,1.16,2072
1,QLD,310,Greenmeadows (Bonner),298,45.02,364,54.98,662,98.95,7,1.05,669
1,QLD,163,Greenmeadows (Griffith),272,51.22,259,48.78,531,99.25,4,0.75,535
1,QLD,164,Greenmount East,69,15.3,382,84.7,451,99.78,1,0.22,452
1,QLD,178,Greens Creek,84,23.01,281,76.99,365,100,0,0,365
1,QLD,163,Greenslopes,1346,64.93,727,35.07,2073,98.57,30,1.43,2103
1,QLD,175,Griffin,886,42.62,1193,57.38,2079,99.09,19,0.91,2098
1,QLD,252,Grovely (Dickson),368,51.54,346,48.46,714,99.44,4,0.56,718
1,QLD,177,Grovely (Ryan),412,62.61,246,37.39,658,98.95,7,1.05,665
1,QLD,310,Gumdale,1249,38.96,1957,61.04,3206,99.1,29,0.9,3235
1,QLD,310,Gumdale North,396,44.8,488,55.2,884,98.66,12,1.34,896
1,QLD,178,Gunalda,49,12.25,351,87.75,400,99.26,3,0.74,403
1,QLD,178,Gympie,253,24.07,798,75.93,1051,98.96,11,1.04,1062
1,QLD,178,Gympie Central,363,24.02,1148,75.98,1511,98.82,18,1.18,1529
1,QLD,178,Gympie East,144,26.62,397,73.38,541,98.9,6,1.1,547
1,QLD,178,Gympie North,239,22.65,816,77.35,1055,99.34,7,0.66,1062
1,QLD,178,Gympie PPVC,2299,17.6,10766,82.4,13065,99.29,94,0.71,13159
1,QLD,170,Haden,14,12.61,97,87.39,111,100,0,0,111
1,QLD,304,Haigslea,50,15.58,271,84.42,321,99.38,2,0.62,323
1,QLD,167,Halifax,45,17.05,219,82.95,264,99.62,1,0.38,265
1,QLD,156,Hamilton,1297,44.3,1631,55.7,2928,99.05,28,0.95,2956
1,QLD,158,Hamilton Island,76,40,114,60,190,97.94,4,2.06,194
1,QLD,158,Hamilton Island PPVC,0,0,0,0,0,0,0,0, -   
1,QLD,158,Hampden,65,14.57,381,85.43,446,99.11,4,0.89,450
1,QLD,167,Happy Valley,80,25.89,229,74.11,309,98.41,5,1.59,314
1,QLD,164,Harlaxton,312,27.11,839,72.89,1151,98.38,19,1.62,1170
1,QLD,159,Harley Park,504,40.81,731,59.19,1235,98.64,17,1.36,1252
1,QLD,164,Harristown,543,31.59,1176,68.41,1719,99.48,9,0.52,1728
1,QLD,164,Harristown South,102,37.23,172,62.77,274,99.28,2,0.72,276
1,QLD,164,Harristown West,96,33.45,191,66.55,287,98.63,4,1.37,291
1,QLD,316,Harrisville,77,20.48,299,79.52,376,99.73,1,0.27,377
1,QLD,316,Hatton Vale,320,17.63,1495,82.37,1815,98.96,19,1.04,1834
1,QLD,167,Healy,134,27.74,349,72.26,483,99.18,4,0.82,487
1,QLD,165,Heatley,465,27.58,1221,72.42,1686,98.89,19,1.11,1705
1,QLD,159,Helensvale,450,33.11,909,66.89,1359,98.76,17,1.24,1376
1,QLD,159,Helensvale FADDEN PPVC,3404,22.08,12012,77.92,15416,99.21,123,0.79,15539
1,QLD,162,Helensvale FORDE PPVC,556,20.54,2151,79.46,2707,99.52,13,0.48,2720
1,QLD,172,Helensvale MONCRIEFF PPVC,182,24.69,555,75.31,737,99.06,7,0.94,744
1,QLD,159,Helensvale North,681,29.08,1661,70.92,2342,99.03,23,0.97,2365
1,QLD,316,Helensvale WRIGHT PPVC,654,24.1,2060,75.9,2714,99.16,23,0.84,2737
1,QLD,316,Helidon,117,20.03,467,79.97,584,98.32,10,1.68,594
1,QLD,310,Hemmant,322,40.76,468,59.24,790,99.12,7,0.88,797
1,QLD,156,Hendra,507,40.43,747,59.57,1254,98.9,14,1.1,1268
1,QLD,167,Herberton,120,21.9,428,78.1,548,99.46,3,0.54,551
1,QLD,176,Heritage Park,527,36.1,933,63.9,1460,98.65,20,1.35,1480
1,QLD,165,Hermit Park,367,39.72,557,60.28,924,98.82,11,1.18,935
1,QLD,165,Hermit Park South,363,38.01,592,61.99,955,99.07,9,0.93,964
1,QLD,166,Hervey Bay PPVC,2248,17.2,10820,82.8,13068,99.41,77,0.59,13145
1,QLD,166,Hervey Bay South PPVC,2374,18.66,10345,81.34,12719,99.5,64,0.5,12783
1,QLD,164,Highfields,399,26.64,1099,73.36,1498,99.47,8,0.53,1506
1,QLD,164,Highfields North,359,28.38,906,71.62,1265,99.61,5,0.39,1270
1,QLD,164,Highfields West,216,26.8,590,73.2,806,99.63,3,0.37,809
1,QLD,172,Highland Park,570,30.14,1321,69.86,1891,98.44,30,1.56,1921
1,QLD,163,Hill End,1252,71.06,510,28.94,1762,99.21,14,0.79,1776
1,QLD,176,Hillcrest (Rankin),343,36.3,602,63.7,945,98.54,14,1.46,959
1,QLD,316,Hillcrest (Wright),115,29.87,270,70.13,385,97.47,10,2.53,395
1,QLD,155,Hilliard,378,30.29,870,69.71,1248,99.13,11,0.87,1259
1,QLD,163,Holland Park Central,1086,62.13,662,37.87,1748,99.37,11,0.63,1759
1,QLD,163,Holland Park East,477,59.55,324,40.45,801,99.38,5,0.62,806
1,QLD,163,Holland Park South,534,59.53,363,40.47,897,99.23,7,0.77,904
1,QLD,310,Holland Park West (Bonner),436,58.84,305,41.16,741,99.46,4,0.54,745
1,QLD,163,Holland Park West (Griffith),223,57.18,167,42.82,390,99.49,2,0.51,392
1,QLD,168,Holloways Beach,332,37.26,559,62.74,891,98.67,12,1.33,903
1,QLD,158,Home Hill,90,17.11,436,82.89,526,99.25,4,0.75,530
1,QLD,159,Hope Island,509,25.59,1480,74.41,1989,99.15,17,0.85,2006
1,QLD,168,Hope Vale,231,75.49,75,24.51,306,99.03,3,0.97,309
1,QLD,168,Horn Island,86,63.24,50,36.76,136,100,0,0,136
1,QLD,166,Howard,176,17.04,857,82.96,1033,99.42,6,0.58,1039
1,QLD,167,Hughenden,21,13.64,133,86.36,154,99.35,1,0.65,155
1,QLD,167,Hughenden PPVC,64,12.55,446,87.45,510,99.8,1,0.2,511
1,QLD,178,Imbil,211,24.74,642,75.26,853,98.96,9,1.04,862
1,QLD,174,Inala,698,45.41,839,54.59,1537,98.97,16,1.03,1553
1,QLD,174,Inala Central,213,49.53,217,50.47,430,97.95,9,2.05,439
1,QLD,173,Inala MORETON PPVC,275,38.3,443,61.7,718,99.03,7,0.97,725
1,QLD,174,Inala OXLEY PPVC,4372,36.51,7602,63.49,11974,98.94,128,1.06,12102
1,QLD,177,Indooroopilly,741,63.55,425,36.45,1166,99.49,6,0.51,1172
1,QLD,177,Indooroopilly East,993,60.81,640,39.19,1633,99.09,15,0.91,1648
1,QLD,173,Indooroopilly MORETON PPVC,1123,45.65,1337,54.35,2460,99.6,10,0.4,2470
1,QLD,177,Indooroopilly RYAN PPVC,5110,51.04,4902,48.96,10012,99.49,51,0.51,10063
1,QLD,177,Indooroopilly West,848,60.18,561,39.82,1409,99.16,12,0.84,1421
1,QLD,167,Ingham,93,19.66,380,80.34,473,99.37,3,0.63,476
1,QLD,167,Ingham PPVC,460,10.11,4091,89.89,4551,99.67,15,0.33,4566
1,QLD,167,Ingham South,59,14.46,349,85.54,408,98.55,6,1.45,414
1,QLD,170,Inglewood,62,10.51,528,89.49,590,99.49,3,0.51,593
1,QLD,170,Injune,26,11.5,200,88.5,226,99.56,1,0.44,227
1,QLD,167,Innisfail,60,31.91,128,68.09,188,99.47,1,0.53,189
1,QLD,167,Innisfail East,215,31.11,476,68.89,691,99.14,6,0.86,697
1,QLD,167,Innisfail North,121,33.89,236,66.11,357,97.54,9,2.46,366
1,QLD,167,Innisfail PPVC,832,16.76,4131,83.24,4963,99.42,29,0.58,4992
1,QLD,170,Inverlaw,13,13.54,83,86.46,96,97.96,2,2.04,98
1,QLD,304,Ipswich BLAIR PPVC,2099,36.02,3728,63.98,5827,99.08,54,0.92,5881
1,QLD,304,Ipswich Central,392,39.44,602,60.56,994,98.81,12,1.19,1006
1,QLD,174,Ipswich OXLEY PPVC,194,42.27,265,57.73,459,98.92,5,1.08,464
1,QLD,304,Ipswich South PPVC,2680,21.43,9828,78.57,12508,99.25,94,0.75,12602
1,QLD,316,Ipswich WRIGHT PPVC,67,31.02,149,68.98,216,99.08,2,0.92,218
1,QLD,177,Ironside,1255,62.59,750,37.41,2005,99.01,20,0.99,2025
1,QLD,172,Isle Of Capri,439,28.36,1109,71.64,1548,98.91,17,1.09,1565
1,QLD,156,Ithaca Creek,886,68.68,404,31.32,1290,99.54,6,0.46,1296
1,QLD,156,Ithaca South,1010,68.94,455,31.06,1465,99.46,8,0.54,1473
1,QLD,159,Jacobs Well,201,17.72,933,82.28,1134,99.3,8,0.7,1142
1,QLD,311,Jambin,13,10.24,114,89.76,127,100,0,0,127
1,QLD,174,Jamboree Heights,906,49.48,925,50.52,1831,99.13,16,0.87,1847
1,QLD,170,Jandowae,65,11.63,494,88.37,559,99.64,2,0.36,561
1,QLD,316,Jimboomba,530,21.99,1880,78.01,2410,98.69,32,1.31,2442
1,QLD,316,Jimboomba East,280,24.22,876,75.78,1156,99.48,6,0.52,1162
1,QLD,316,Jimboomba PPVC,1591,18.61,6958,81.39,8549,99.37,54,0.63,8603
1,QLD,174,Jindalee,790,48.86,827,51.14,1617,98.72,21,1.28,1638
1,QLD,174,Jindalee South,495,45.25,599,54.75,1094,98.92,12,1.08,1106
1,QLD,164,Jondaryan,25,13.23,164,86.77,189,98.44,3,1.56,192
1,QLD,167,Julatten,98,27.22,262,72.78,360,98.9,4,1.1,364
1,QLD,167,Julia Creek,23,11.44,178,88.56,201,100,0,0,201
1,QLD,173,Junction Park,733,67.68,350,32.32,1083,99.09,10,0.91,1093
1,QLD,170,Kaimkillenbun,12,12.12,87,87.88,99,100,0,0,99
1,QLD,167,Kairi,28,15.64,151,84.36,179,98.9,2,1.1,181
1,QLD,316,Kalbar,105,16.61,527,83.39,632,99.68,2,0.32,634
1,QLD,156,Kalinga (Brisbane),630,58.82,441,41.18,1071,99.63,4,0.37,1075
1,QLD,169,Kalinga (Lilley),114,54.81,94,45.19,208,100,0,0,208
1,QLD,167,Kalkadoon,128,34.88,239,65.12,367,98.92,4,1.08,371
1,QLD,166,Kalkie,149,23.61,482,76.39,631,99.37,4,0.63,635
1,QLD,252,Kallangur (Dickson),421,35.53,764,64.47,1185,99.83,2,0.17,1187
1,QLD,302,Kallangur (Longman),231,33.38,461,66.62,692,98.44,11,1.56,703
1,QLD,252,Kallangur DICKSON PPVC,1490,26.12,4214,73.88,5704,99.34,38,0.66,5742
1,QLD,252,Kallangur East,292,33.03,592,66.97,884,99.44,5,0.56,889
1,QLD,302,Kallangur LONGMAN PPVC,535,26.83,1459,73.17,1994,98.66,27,1.34,2021
1,QLD,175,Kallangur PETRIE PPVC,448,30.75,1009,69.25,1457,98.98,15,1.02,1472
1,QLD,252,Kallangur West (Dickson),176,33.33,352,66.67,528,99.06,5,0.94,533
1,QLD,302,Kallangur West (Longman),229,33.19,461,66.81,690,98.71,9,1.29,699
1,QLD,168,Kamerunga,97,37.31,163,62.69,260,99.62,1,0.38,261
1,QLD,178,Kandanga,85,23.55,276,76.45,361,98.9,4,1.1,365
1,QLD,163,Kangaroo Point,1055,57.62,776,42.38,1831,99.13,16,0.87,1847
1,QLD,304,Karalee,730,30.6,1656,69.4,2386,99,24,1,2410
1,QLD,304,Karana Downs,803,40.87,1162,59.13,1965,99.34,13,0.66,1978
1,QLD,167,Karumba,17,11.64,129,88.36,146,100,0,0,146
1,QLD,157,Kawana,433,22.96,1453,77.04,1886,99.21,15,0.79,1901
1,QLD,161,Kawana Waters,567,38.21,917,61.79,1484,98.47,23,1.53,1507
1,QLD,166,Kawungan,446,23.66,1439,76.34,1885,99.21,15,0.79,1900
1,QLD,169,Kedron,902,58.19,648,41.81,1550,99.49,8,0.51,1558
1,QLD,169,Kedron Heights,739,54.86,608,45.14,1347,99.34,9,0.66,1356
1,QLD,172,Keebra Park,196,38.43,314,61.57,510,99.03,5,0.97,515
1,QLD,165,Kelso,380,22.02,1346,77.98,1726,98.97,18,1.03,1744
1,QLD,156,Kelvin Grove,1599,70.72,662,29.28,2261,99.47,12,0.53,2273
1,QLD,160,Kenilworth,115,26.68,316,73.32,431,100,0,0,431
1,QLD,177,Kenmore,958,54.71,793,45.29,1751,99.49,9,0.51,1760
1,QLD,177,Kenmore South,1123,55.87,887,44.13,2010,99.16,17,0.84,2027
1,QLD,167,Kennedy Central,24,12.57,167,87.43,191,99.48,1,0.52,192
1,QLD,316,Kentville,23,14.84,132,85.16,155,98.1,3,1.9,158
1,QLD,177,Keperra,653,47.05,735,52.95,1388,99.28,10,0.72,1398
1,QLD,166,Kepnock,270,25.38,794,74.62,1064,99.16,9,0.84,1073
1,QLD,157,Keppel Sands,50,18.73,217,81.27,267,100,0,0,267
1,QLD,316,Kerry,22,17.19,106,82.81,128,100,0,0,128
1,QLD,168,Kewarra Beach,254,29.57,605,70.43,859,98.62,12,1.38,871
1,QLD,304,Kilcoy,269,20.49,1044,79.51,1313,99.17,11,0.83,1324
1,QLD,178,Kilkivan,53,10.73,441,89.27,494,99.4,3,0.6,497
1,QLD,170,Killarney,62,12.81,422,87.19,484,99.79,1,0.21,485
1,QLD,162,Kimberley Park,520,41.11,745,58.89,1265,98.52,19,1.48,1284
1,QLD,178,Kin Kin,143,40.97,206,59.03,349,98.87,4,1.13,353
1,QLD,311,Kin Kora,259,24.18,812,75.82,1071,99.35,7,0.65,1078
1,QLD,170,Kingaroy,186,21.21,691,78.79,877,98.87,10,1.13,887
1,QLD,170,Kingaroy East,168,21.57,611,78.43,779,99.11,7,0.89,786
1,QLD,311,Kingaroy FLYNN PPVC,129,16.1,672,83.9,801,99.5,4,0.5,805
1,QLD,170,Kingaroy MARANOA PPVC,859,14.21,5187,85.79,6046,99.62,23,0.38,6069
1,QLD,164,Kingsthorpe,132,15.09,743,84.91,875,98.98,9,1.02,884
1,QLD,176,Kingston,544,39.39,837,60.61,1381,97.8,31,2.2,1412
1,QLD,175,Kippa-Ring,445,31.21,981,68.79,1426,98.01,29,1.99,1455
1,QLD,175,Kippa-Ring West,586,35.49,1065,64.51,1651,99.16,14,0.84,1665
1,QLD,171,Kirra,490,42.02,676,57.98,1166,94.49,68,5.51,1234
1,QLD,165,Kirwan,531,25.33,1565,74.67,2096,99.05,20,0.95,2116
1,QLD,165,Kirwan East,425,23.48,1385,76.52,1810,99.29,13,0.71,1823
1,QLD,165,Kirwan HERBERT PPVC,2674,14.71,15498,85.29,18172,99.42,106,0.58,18278
1,QLD,167,Kirwan KENNEDY PPVC,92,10.23,807,89.77,899,99.89,1,0.11,900
1,QLD,165,Kirwan South,286,24.68,873,75.32,1159,98.55,17,1.45,1176
1,QLD,170,Kogan,14,14.43,83,85.57,97,97.98,2,2.02,99
1,QLD,157,Koongal,346,26.53,958,73.47,1304,99.09,12,0.91,1316
1,QLD,316,Kooralbyn,123,22.08,434,77.92,557,98.58,8,1.42,565
1,QLD,157,Koumala,28,7.25,358,92.75,386,99.74,1,0.26,387
1,QLD,168,Kowanyama,203,51.26,193,48.74,396,99,4,1,400
1,QLD,164,Kulpi,14,9.21,138,90.79,152,100,0,0,152
1,QLD,160,Kuluin,380,39.18,590,60.82,970,99.49,5,0.51,975
1,QLD,170,Kumbia,29,12.13,210,87.87,239,99.58,1,0.42,240
1,QLD,173,Kuraby (Moreton),1022,52.22,935,47.78,1957,98.14,37,1.86,1994
1,QLD,176,Kuraby (Rankin),346,52.42,314,47.58,660,97.63,16,2.37,676
1,QLD,168,Kuranda,596,46.35,690,53.65,1286,98.7,17,1.3,1303
1,QLD,160,Kureelpa,168,34.64,317,65.36,485,98.38,8,1.62,493
1,QLD,167,Kurrimine Beach,50,14.97,284,85.03,334,98.53,5,1.47,339
1,QLD,252,Kurwongbah,532,37.07,903,62.93,1435,98.76,18,1.24,1453
1,QLD,159,Labrador,825,41.13,1181,58.87,2006,98.09,39,1.91,2045
1,QLD,159,Labrador FADDEN PPVC,1022,30.26,2355,69.74,3377,99.18,28,0.82,3405
1,QLD,172,Labrador MONCRIEFF PPVC,177,30,413,70,590,98.5,9,1.5,599
1,QLD,316,Laidley,374,20.62,1440,79.38,1814,98.96,19,1.04,1833
1,QLD,316,Lake Clarendon,44,14.24,265,85.76,309,100,0,0,309
1,QLD,157,Lakes Creek,140,20.65,538,79.35,678,99.27,5,0.73,683
1,QLD,161,Landsborough,429,31.18,947,68.82,1376,98.99,14,1.01,1390
1,QLD,252,Lawnton,611,37.58,1015,62.42,1626,99.03,16,0.97,1642
1,QLD,304,Leichhardt,344,32.79,705,67.21,1049,98.59,15,1.41,1064
1,QLD,170,Leyburn,38,14.23,229,85.77,267,100,0,0,267
1,QLD,168,Lockhart River,170,66.15,87,33.85,257,98.09,5,1.91,262
1,QLD,162,Logan Reserve,695,33.79,1362,66.21,2057,98.85,24,1.15,2081
1,QLD,162,Logan Village (Forde),131,24.49,404,75.51,535,99.63,2,0.37,537
1,QLD,316,Logan Village (Wright),443,24.19,1388,75.81,1831,98.97,19,1.03,1850
1,QLD,162,Loganholme,602,30.15,1395,69.85,1997,97.84,44,2.16,2041
1,QLD,162,Loganholme FORDE PPVC,1148,26.66,3158,73.34,4306,98.29,75,1.71,4381
1,QLD,176,Loganholme RANKIN PPVC,66,23.83,211,76.17,277,97.54,7,2.46,284
1,QLD,162,Loganlea,287,34.17,553,65.83,840,98.82,10,1.18,850
1,QLD,167,Long Pocket,12,9.52,114,90.48,126,99.21,1,0.79,127
1,QLD,170,Longreach,119,20.1,473,79.9,592,99.33,4,0.67,596
1,QLD,170,Longreach PPVC,147,15.38,809,84.62,956,99.58,4,0.42,960
1,QLD,310,Lota,499,50.35,492,49.65,991,99.5,5,0.5,996
1,QLD,167,Lower Tully,31,18.45,137,81.55,168,100,0,0,168
1,QLD,178,Lower Wonga,41,14.14,249,85.86,290,98.64,4,1.36,294
1,QLD,304,Lowood,324,22.28,1130,77.72,1454,98.38,24,1.62,1478
1,QLD,167,Lucinda,11,8.4,120,91.6,131,100,0,0,131
1,QLD,156,Lutwyche,1018,62,624,38,1642,99.21,13,0.79,1655
1,QLD,316,Ma Ma Creek,26,16.15,135,83.85,161,99.38,1,0.62,162
1,QLD,176,Mabel Park,513,40.2,763,59.8,1276,98.53,19,1.47,1295
1,QLD,173,Macgregor,276,38.39,443,61.61,719,99.04,7,0.96,726
1,QLD,173,Macgregor West,394,37.2,665,62.8,1059,98.51,16,1.49,1075
1,QLD,168,Machans Beach,218,46.68,249,53.32,467,98.52,7,1.48,474
1,QLD,158,Mackay,474,23.57,1537,76.43,2011,98.77,25,1.23,2036
1,QLD,157,Mackay CAPRICORNIA PPVC,768,12.19,5532,87.81,6300,99.46,34,0.54,6334
1,QLD,158,Mackay DAWSON PPVC,3830,17.08,18600,82.92,22430,99.25,170,0.75,22600
1,QLD,158,Mackay Goose Ponds,230,28.05,590,71.95,820,98.68,11,1.32,831
1,QLD,158,Mackay South,284,27.26,758,72.74,1042,99.05,10,0.95,1052
1,QLD,158,Mackay Town Beach,441,26.31,1235,73.69,1676,99.05,16,0.95,1692
1,QLD,158,Mackay West,348,32.25,731,67.75,1079,98.99,11,1.01,1090
1,QLD,310,Mackenzie,330,39.15,513,60.85,843,99.53,4,0.47,847
1,QLD,167,Macknade,7,6.86,95,93.14,102,98.08,2,1.92,104
1,QLD,155,Macleay Island,478,33.76,938,66.24,1416,99.09,13,0.91,1429
1,QLD,170,Maidenwell,12,10.26,105,89.74,117,96.69,4,3.31,121
1,QLD,172,Main Beach,373,30.3,858,69.7,1231,99.27,9,0.73,1240
1,QLD,167,Malanda,252,21.82,903,78.18,1155,99.31,8,0.69,1163
1,QLD,161,Maleny,503,49.7,509,50.3,1012,98.35,17,1.65,1029
1,QLD,161,Maleny PPVC,1832,43.84,2347,56.16,4179,99.19,34,0.81,4213
1,QLD,175,Mango Hill,334,37.07,567,62.93,901,98.9,10,1.1,911
1,QLD,175,Mango Hill South,1007,41.7,1408,58.3,2415,99.06,23,0.94,2438
1,QLD,310,Manly,475,51.19,453,48.81,928,99.25,7,0.75,935
1,QLD,310,Manly West,496,45.38,597,54.62,1093,98.47,17,1.53,1110
1,QLD,310,Mansfield,1012,46.44,1167,53.56,2179,99.18,18,0.82,2197
1,QLD,310,Mansfield BONNER PPVC,3502,37.38,5867,62.62,9369,99.49,48,0.51,9417
1,QLD,163,Mansfield GRIFFITH PPVC,453,41.75,632,58.25,1085,99,11,1,1096
1,QLD,173,Mansfield MORETON PPVC,546,37.07,927,62.93,1473,99.26,11,0.74,1484
1,QLD,310,Mansfield North,194,33.74,381,66.26,575,99.48,3,0.52,578
1,QLD,168,Manunda,145,43.15,191,56.85,336,99.12,3,0.88,339
1,QLD,160,Mapleton,437,44.14,553,55.86,990,99.4,6,0.6,996
1,QLD,304,Marburg,108,24.05,341,75.95,449,98.03,9,1.97,458
1,QLD,167,Mareeba,64,18.77,277,81.23,341,99.42,2,0.58,343
1,QLD,167,Mareeba KENNEDY PPVC,998,13.92,6169,86.08,7167,99.46,39,0.54,7206
1,QLD,168,Mareeba LEICHHARDT PPVC,0,0,0,0,0,0,0,0, -   
1,QLD,167,Mareeba North,140,17.31,669,82.69,809,99.26,6,0.74,815
1,QLD,167,Mareeba West,60,31.41,131,68.59,191,99.48,1,0.52,192
1,QLD,175,Margate,661,41.26,941,58.74,1602,98.95,17,1.05,1619
1,QLD,157,Marian,180,12.55,1254,87.45,1434,99.38,9,0.62,1443
1,QLD,160,Maroochydore,529,38.98,828,61.02,1357,98.62,19,1.38,1376
1,QLD,160,Maroochydore East,762,43.1,1006,56.9,1768,98.44,28,1.56,1796
1,QLD,160,Maroochydore FAIRFAX PPVC,3555,27.88,9195,72.12,12750,99.07,120,0.93,12870
1,QLD,161,Maroochydore FISHER PPVC,973,30.49,2218,69.51,3191,99.16,27,0.84,3218
1,QLD,162,Marsden (Forde),515,36.4,900,63.6,1415,97.59,35,2.41,1450
1,QLD,176,Marsden (Rankin),411,39.9,619,60.1,1030,99.04,10,0.96,1040
1,QLD,178,Maryborough,217,22.37,753,77.63,970,98.98,10,1.02,980
1,QLD,178,Maryborough East,369,26.95,1000,73.05,1369,98.84,16,1.16,1385
1,QLD,166,Maryborough HINKLER PPVC,175,17.78,809,82.22,984,99.49,5,0.51,989
1,QLD,178,Maryborough North,174,22.17,611,77.83,785,99.24,6,0.76,791
1,QLD,178,Maryborough West,202,16.46,1025,83.54,1227,98.87,14,1.13,1241
1,QLD,178,Maryborough WIDE BAY PPVC,1971,16.25,10155,83.75,12126,99.33,82,0.67,12208
1,QLD,170,Maryvale,25,14.04,153,85.96,178,99.44,1,0.56,179
1,QLD,170,Massie,28,13.27,183,86.73,211,100,0,0,211
1,QLD,167,Mcdonnell Creek,21,14.89,120,85.11,141,97.92,3,2.08,144
1,QLD,252,McDowall (Dickson),312,41.66,437,58.34,749,98.68,10,1.32,759
1,QLD,169,McDowall (Lilley),805,47.77,880,52.23,1685,98.94,18,1.06,1703
1,QLD,169,McDowall South,183,57.19,137,42.81,320,98.77,4,1.23,324
1,QLD,162,Meadowbrook (Forde),115,41.97,159,58.03,274,99.64,1,0.36,275
1,QLD,176,Meadowbrook (Rankin),99,40.41,146,59.59,245,99.19,2,0.81,247
1,QLD,170,Meandarra,16,9.82,147,90.18,163,100,0,0,163
1,QLD,167,Mena Creek,49,21.97,174,78.03,223,98.67,3,1.33,226
1,QLD,161,Meridan Plains North,245,47.48,271,52.52,516,99.04,5,0.96,521
1,QLD,161,Meridan Plains South,713,31.59,1544,68.41,2257,98.82,27,1.18,2284
1,QLD,164,Meringandan,202,18.69,879,81.31,1081,99.72,3,0.28,1084
1,QLD,172,Mermaid Beach,530,41.9,735,58.1,1265,99.06,12,0.94,1277
1,QLD,171,Merrimac (McPherson),471,32.51,978,67.49,1449,98.17,27,1.83,1476
1,QLD,172,Merrimac (Moncrieff),233,28.38,588,71.62,821,98.56,12,1.44,833
1,QLD,171,Merrimac East (McPherson),95,32.09,201,67.91,296,99.66,1,0.34,297
1,QLD,172,Merrimac East (Moncrieff),440,32.21,926,67.79,1366,98.7,18,1.3,1384
1,QLD,156,Merthyr,1175,63.27,682,36.73,1857,99.41,11,0.59,1868
1,QLD,168,Miallo,57,21.92,203,78.08,260,99.62,1,0.38,261
1,QLD,172,Miami,387,49.17,400,50.83,787,99.12,7,0.88,794
1,QLD,171,Miami West (McPherson),115,41.82,160,58.18,275,98.21,5,1.79,280
1,QLD,172,Miami West (Moncrieff),697,42.92,927,57.08,1624,97.6,40,2.4,1664
1,QLD,174,Middle Park,968,45.02,1182,54.98,2150,98.9,24,1.1,2174
1,QLD,174,Middle Park East,510,46.66,583,53.34,1093,99.36,7,0.64,1100
1,QLD,164,Middle Ridge,769,31.95,1638,68.05,2407,99.18,20,0.82,2427
1,QLD,157,Middlemount,60,14.12,365,85.88,425,99.07,4,0.93,429
1,QLD,170,Miles,64,11.11,512,88.89,576,99.31,4,0.69,580
1,QLD,170,Miles PPVC,67,11.82,500,88.18,567,100,0,0,567
1,QLD,167,Millaa Millaa,65,22.03,230,77.97,295,98.01,6,1.99,301
1,QLD,170,Millmerran,121,12.19,872,87.81,993,99.6,4,0.4,997
1,QLD,156,Milton (Brisbane),1076,64.98,580,35.02,1656,99.28,12,0.72,1668
1,QLD,177,Milton (Ryan),257,64.9,139,35.1,396,99.75,1,0.25,397
1,QLD,304,Minden,119,17.22,572,82.78,691,99.28,5,0.72,696
1,QLD,157,Mirani,150,16.16,778,83.84,928,99.25,7,0.75,935
1,QLD,311,Miriam Vale,58,11.49,447,88.51,505,100,0,0,505
1,QLD,167,Mirriwinni,74,18.36,329,81.64,403,99.51,2,0.49,405
1,QLD,167,Mission Beach,259,37.27,436,62.73,695,99,7,1,702
1,QLD,170,Mitchell,72,13.95,444,86.05,516,98.66,7,1.34,523
1,QLD,177,Mitchelton,761,56.16,594,43.84,1355,99.12,12,0.88,1367
1,QLD,177,Moggill,1035,48.32,1107,51.68,2142,98.94,23,1.06,2165
1,QLD,172,Molendinar,173,38.02,282,61.98,455,99.34,3,0.66,458
1,QLD,311,Mondure,20,11.05,161,88.95,181,98.91,2,1.09,183
1,QLD,178,Monkland,160,19.66,654,80.34,814,99.51,4,0.49,818
1,QLD,311,Monto,85,12.04,621,87.96,706,99.02,7,0.98,713
1,QLD,161,Montville,125,40.58,183,59.42,308,98.09,6,1.91,314
1,QLD,161,Mooloolaba,753,42.57,1016,57.43,1769,98.39,29,1.61,1798
1,QLD,161,Mooloolah,415,31.92,885,68.08,1300,98.86,15,1.14,1315
1,QLD,304,Moore,54,20.3,212,79.7,266,99.25,2,0.75,268
1,QLD,311,Moore Park Beach,238,21.42,873,78.58,1111,99.29,8,0.71,1119
1,QLD,168,Mooroobool,400,35.84,716,64.16,1116,98.94,12,1.06,1128
1,QLD,173,Moorooka,490,63.8,278,36.2,768,99.48,4,0.52,772
1,QLD,173,Moorooka East,1084,64.6,594,35.4,1678,98.59,24,1.41,1702
1,QLD,173,Moorvale,760,66.61,381,33.39,1141,99.39,7,0.61,1148
1,QLD,157,Moranbah,258,21.32,952,78.68,1210,99.18,10,0.82,1220
1,QLD,157,Moranbah PPVC,361,15.73,1934,84.27,2295,99.48,12,0.52,2307
1,QLD,302,Morayfield,732,30.69,1653,69.31,2385,98.31,41,1.69,2426
1,QLD,302,Morayfield East,692,27.65,1811,72.35,2503,98.47,39,1.53,2542
1,QLD,302,Morayfield PPVC,2480,21.69,8956,78.31,11436,99.12,102,0.88,11538
1,QLD,302,Morayfield West,559,25.99,1592,74.01,2151,98.9,24,1.1,2175
1,QLD,175,Moreton Downs,204,28.85,503,71.15,707,98.33,12,1.67,719
1,QLD,163,Morningside,772,60.88,496,39.12,1268,98.68,17,1.32,1285
1,QLD,163,Morningside South,1562,61.11,994,38.89,2556,98.92,28,1.08,2584
1,QLD,167,Mornington Island,280,77.78,80,22.22,360,98.63,5,1.37,365
1,QLD,170,Morven,19,13.19,125,86.81,144,100,0,0,144
1,QLD,168,Mossman,465,35.28,853,64.72,1318,97.92,28,2.08,1346
1,QLD,316,Mount Alford,40,22.73,136,77.27,176,98.88,2,1.12,178
1,QLD,167,Mount Garnet,34,13.55,217,86.45,251,99.6,1,0.4,252
1,QLD,310,Mount Gravatt,514,58.21,369,41.79,883,99.1,8,0.9,891
1,QLD,310,Mount Gravatt East (Bonner),778,54.79,642,45.21,1420,98.82,17,1.18,1437
1,QLD,163,Mount Gravatt East (Griffith),123,59.13,85,40.87,208,98.58,3,1.42,211
1,QLD,167,Mount Isa,314,27.86,813,72.14,1127,98.86,13,1.14,1140
1,QLD,304,Mount Kilcoy,60,16.71,299,83.29,359,99.72,1,0.28,360
1,QLD,311,Mount Larcom,30,6.79,412,93.21,442,99.77,1,0.23,443
1,QLD,164,Mount Lofty,317,39.82,479,60.18,796,99.25,6,0.75,802
1,QLD,165,Mount Louisa,410,23.12,1363,76.88,1773,98.83,21,1.17,1794
1,QLD,302,Mount Mee,73,32.88,149,67.12,222,99.55,1,0.45,223
1,QLD,311,Mount Morgan,242,20.03,966,79.97,1208,98.69,16,1.31,1224
1,QLD,252,Mount Nebo,186,73.81,66,26.19,252,96.92,8,3.08,260
1,QLD,311,Mount Perry,30,10.1,267,89.9,297,97.7,7,2.3,304
1,QLD,158,Mount Pleasant East,350,25.18,1040,74.82,1390,99.14,12,0.86,1402
1,QLD,158,Mount Pleasant West,191,23.29,629,76.71,820,99.27,6,0.73,826
1,QLD,304,Mount Tarampa,43,17,210,83,253,98.83,3,1.17,256
1,QLD,310,Mount Thompson,413,56.19,322,43.81,735,99.06,7,0.94,742
1,QLD,164,Mount Tyson,21,9.46,201,90.54,222,100,0,0,222
1,QLD,162,Mount Warren Park,400,28.33,1012,71.67,1412,90.75,144,9.25,1556
1,QLD,160,Mountain Creek,622,37.27,1047,62.73,1669,98.7,22,1.3,1691
1,QLD,160,Mountain Creek South,488,38.49,780,61.51,1268,99.37,8,0.63,1276
1,QLD,311,Moura,117,15.92,618,84.08,735,99.86,1,0.14,736
1,QLD,167,Mourilyan,61,13.83,380,86.17,441,99.55,2,0.45,443
1,QLD,155,Mt Cotton,589,31.8,1263,68.2,1852,98.83,22,1.17,1874
1,QLD,310,Mt Gravatt West,623,60.66,404,39.34,1027,99.13,9,0.87,1036
1,QLD,167,Mt Isa PPVC,827,18.67,3603,81.33,4430,99.42,26,0.58,4456
1,QLD,171,Mudgeeraba (McPherson),130,37.79,214,62.21,344,98.85,4,1.15,348
1,QLD,316,Mudgeeraba (Wright),162,35.06,300,64.94,462,98.72,6,1.28,468
1,QLD,160,Mudjimba,455,41.25,648,58.75,1103,99.01,11,0.99,1114
1,QLD,311,Mulgildie,19,9.18,188,90.82,207,99.52,1,0.48,208
1,QLD,165,Mundingburra,526,37.07,893,62.93,1419,99.02,14,0.98,1433
1,QLD,311,Mundubbera,86,12.65,594,87.35,680,99.71,2,0.29,682
1,QLD,178,Mungar,48,14.5,283,85.5,331,99.1,3,0.9,334
1,QLD,170,Mungindi,8,8.99,81,91.01,89,100,0,0,89
1,QLD,310,Murarrie (Bonner),529,52.22,484,47.78,1013,98.83,12,1.17,1025
1,QLD,163,Murarrie (Griffith),270,55.33,218,44.67,488,100,0,0,488
1,QLD,178,Murgon,200,17.17,965,82.83,1165,98.81,14,1.19,1179
1,QLD,316,Murphys Creek,88,19.56,362,80.44,450,98.9,5,1.1,455
1,QLD,167,Murray Upper,35,25.18,104,74.82,139,100,0,0,139
1,QLD,170,Murrays Bridge,13,12.62,90,87.38,103,100,0,0,103
1,QLD,252,Murrumba Downs (Dickson),644,36.3,1130,63.7,1774,98.94,19,1.06,1793
1,QLD,175,Murrumba Downs (Petrie),191,36.73,329,63.27,520,99.43,3,0.57,523
1,QLD,252,Murrumba Downs North,242,34.97,450,65.03,692,98.58,10,1.42,702
1,QLD,167,Mutchilba,10,10.53,85,89.47,95,98.96,1,1.04,96
1,QLD,316,Mutdapilly,29,16.11,151,83.89,180,100,0,0,180
1,QLD,160,Nambour,636,37.21,1073,62.79,1709,98.67,23,1.33,1732
1,QLD,160,Nambour FAIRFAX PPVC,3396,29.39,8159,70.61,11555,98.96,121,1.04,11676
1,QLD,161,Nambour FISHER PPVC,622,29.51,1486,70.49,2108,98.97,22,1.03,2130
1,QLD,160,Nambour West,348,36.55,604,63.45,952,98.76,12,1.24,964
1,QLD,170,Nanango,78,19.12,330,80.88,408,99.03,4,0.97,412
1,QLD,170,Nanango East,84,14.31,503,85.69,587,98.66,8,1.34,595
1,QLD,170,Nanango PPVC,509,17.24,2443,82.76,2952,99.53,14,0.47,2966
1,QLD,302,Narangba,413,30.96,921,69.04,1334,99.26,10,0.74,1344
1,QLD,302,Narangba North,389,35.05,721,64.95,1110,98.67,15,1.33,1125
1,QLD,302,Narangba Valley,825,31.31,1810,68.69,2635,98.76,33,1.24,2668
1,QLD,157,Nebo,30,9.55,284,90.45,314,99.37,2,0.63,316
1,QLD,165,Nelly Bay,328,43.44,427,56.56,755,98.56,11,1.44,766
1,QLD,172,Nerang,191,33.99,371,66.01,562,99.12,5,0.88,567
1,QLD,172,Nerang East,124,23.53,403,76.47,527,99.06,5,0.94,532
1,QLD,172,Nerang South,415,27.27,1107,72.73,1522,98.38,25,1.62,1547
1,QLD,172,Nerang West (Moncrieff),617,31.82,1322,68.18,1939,98.78,24,1.22,1963
1,QLD,316,Nerang West (Wright),215,27.15,577,72.85,792,99.37,5,0.63,797
1,QLD,156,New Farm,1545,63.76,878,36.24,2423,98.62,34,1.38,2457
1,QLD,156,New Farm South,789,57.76,577,42.24,1366,99.27,10,0.73,1376
1,QLD,156,Newmarket,1274,65.47,672,34.53,1946,99.08,18,0.92,1964
1,QLD,156,Newmarket South,546,68.59,250,31.41,796,99.75,2,0.25,798
1,QLD,156,Newstead,555,62.78,329,37.22,884,98.55,13,1.45,897
1,QLD,164,Newtown,509,35.5,925,64.5,1434,98.42,23,1.58,1457
1,QLD,304,Newtown Ipswich,347,45.48,416,54.52,763,99.09,7,0.91,770
1,QLD,302,Ningi,304,26.07,862,73.93,1166,98.23,21,1.77,1187
1,QLD,170,Nobby,20,11.49,154,88.51,174,100,0,0,174
1,QLD,158,Nome,163,18.93,698,81.07,861,99.19,7,0.81,868
1,QLD,178,Noosa Heads,707,54.72,585,45.28,1292,99,13,1,1305
1,QLD,178,Noosa Heads PPVC,0,0,0,0,0,0,0,0, -   
1,QLD,178,Noosaville,223,42.88,297,57.12,520,98.86,6,1.14,526
1,QLD,178,Noosaville East,567,43.58,734,56.42,1301,98.71,17,1.29,1318
1,QLD,178,Noosaville West,277,35.7,499,64.3,776,98.23,14,1.77,790
1,QLD,162,Norfolk Village,310,24.43,959,75.57,1269,98.83,15,1.17,1284
1,QLD,157,Norman Gardens North,463,29.49,1107,70.51,1570,99.05,15,0.95,1585
1,QLD,157,Norman Gardens South,186,29.38,447,70.62,633,99.37,4,0.63,637
1,QLD,163,Norman Park,879,59.67,594,40.33,1473,99.19,12,0.81,1485
1,QLD,163,Norman Park South,934,59.68,631,40.32,1565,98.8,19,1.2,1584
1,QLD,167,Normanton,141,49.13,146,50.87,287,100,0,0,287
1,QLD,160,North Arm,254,37.8,418,62.2,672,99.12,6,0.88,678
1,QLD,304,North Booval,259,37.48,432,62.52,691,98.29,12,1.71,703
1,QLD,304,North Ipswich,198,36.8,340,63.2,538,97.82,12,2.18,550
1,QLD,304,North Ipswich PPVC,2248,27.38,5962,72.62,8210,99.2,66,0.8,8276
1,QLD,175,North Lakes,541,37.96,884,62.04,1425,98.68,19,1.32,1444
1,QLD,252,North Lakes DICKSON PPVC,276,27.71,720,72.29,996,99.1,9,0.9,1005
1,QLD,302,North Lakes LONGMAN PPVC,646,27.89,1670,72.11,2316,98.85,27,1.15,2343
1,QLD,175,North Lakes North,1093,37.23,1843,62.77,2936,98.89,33,1.11,2969
1,QLD,175,North Lakes PETRIE PPVC,2840,32.15,5993,67.85,8833,99.2,71,0.8,8904
1,QLD,165,North Shore,571,26.16,1612,73.84,2183,99.23,17,0.77,2200
1,QLD,164,North Toowoomba PPVC,1175,22.96,3943,77.04,5118,99.53,24,0.47,5142
1,QLD,165,North Ward,765,41,1101,59,1866,99.2,15,0.8,1881
1,QLD,165,Northern Beaches,303,17.78,1401,82.22,1704,99.42,10,0.58,1714
1,QLD,168,Northern Beaches PPVC,3071,28.51,7702,71.49,10773,99.21,86,0.79,10859
1,QLD,169,Northgate,216,47.37,240,52.63,456,98.7,6,1.3,462
1,QLD,166,Norville,317,25.75,914,74.25,1231,98.88,14,1.12,1245
1,QLD,169,Nudgee,746,49.05,775,50.95,1521,99.22,12,0.78,1533
1,QLD,169,Nudgee West,701,51.02,673,48.98,1374,98.85,16,1.15,1390
1,QLD,169,Nundah,1626,59.87,1090,40.13,2716,98.84,32,1.16,2748
1,QLD,169,Nundah East,764,56.68,584,43.32,1348,98.83,16,1.17,1364
1,QLD,169,Nundah North,625,58.96,435,41.04,1060,99.25,8,0.75,1068
1,QLD,164,Oakey,250,14.52,1472,85.48,1722,99.31,12,0.69,1734
1,QLD,304,One Mile,339,32.22,713,67.78,1052,99.43,6,0.57,1058
1,QLD,158,Oonoonba,422,29.8,994,70.2,1416,86.13,228,13.87,1644
1,QLD,157,Ooralea,155,23.41,507,76.59,662,99.25,5,0.75,667
1,QLD,159,Ormeau,500,25.76,1441,74.24,1941,98.78,24,1.22,1965
1,QLD,162,Ormeau North,263,25.89,753,74.11,1016,98.55,15,1.45,1031
1,QLD,155,Ormiston,649,36.9,1110,63.1,1759,98.93,19,1.07,1778
1,QLD,156,Other Mobile Team 1,12,66.67,6,33.33,18,100,0,0,18
1,QLD,304,Other Mobile Team 1,13,31.71,28,68.29,41,100,0,0,41
1,QLD,302,Other Mobile Team 1,5,16.13,26,83.87,31,100,0,0,31
1,QLD,174,Other Mobile Team 1,8,50,8,50,16,100,0,0,16
1,QLD,158,Other Mobile Team 1,8,33.33,16,66.67,24,100,0,0,24
1,QLD,167,Other Mobile Team 1,46,90.2,5,9.8,51,98.08,1,1.92,52
1,QLD,157,Other Mobile Team 1,27,50,27,50,54,100,0,0,54
1,QLD,316,Other Mobile Team 1,5,83.33,1,16.67,6,100,0,0,6
1,QLD,178,Other Mobile Team 1,17,30.91,38,69.09,55,100,0,0,55
1,QLD,174,Other Mobile Team 2,11,36.67,19,63.33,30,100,0,0,30
1,QLD,167,Other Mobile Team 2,43,84.31,8,15.69,51,100,0,0,51
1,QLD,158,Other Mobile Team 2,5,23.81,16,76.19,21,100,0,0,21
1,QLD,157,Other Mobile Team 2,28,31.11,62,68.89,90,97.83,2,2.17,92
1,QLD,316,Other Mobile Team 2,0,0,0,0,0,0,0,0, -   
1,QLD,302,Other Mobile Team 2,13,20,52,80,65,100,0,0,65
1,QLD,174,Other Mobile Team 3,8,50,8,50,16,100,0,0,16
1,QLD,316,Other Mobile Team 3,5,45.45,6,54.55,11,100,0,0,11
1,QLD,174,Other Mobile Team 4,6,31.58,13,68.42,19,100,0,0,19
1,QLD,174,Other Mobile Team 5,8,66.67,4,33.33,12,100,0,0,12
1,QLD,159,Oxenford (Fadden),376,29.68,891,70.32,1267,98.83,15,1.17,1282
1,QLD,162,Oxenford (Forde),145,32.81,297,67.19,442,98.66,6,1.34,448
1,QLD,316,Oxenford (Wright),154,29.22,373,70.78,527,99.25,4,0.75,531
1,QLD,177,Oxford Park,686,63.52,394,36.48,1080,99.82,2,0.18,1082
1,QLD,173,Oxley (Moreton),554,63.1,324,36.9,878,98.43,14,1.57,892
1,QLD,174,Oxley (Oxley),447,53.66,386,46.34,833,98.46,13,1.54,846
1,QLD,173,Oxley South (Moreton),175,60.76,113,39.24,288,97.3,8,2.7,296
1,QLD,174,Oxley South (Oxley),390,55.4,314,44.6,704,99.58,3,0.42,707
1,QLD,160,Pacific Paradise,697,36.32,1222,63.68,1919,98.31,33,1.69,1952
1,QLD,159,Pacific Pines,653,30.77,1469,69.23,2122,98.61,30,1.39,2152
1,QLD,159,Pacific Pines Central,238,31.99,506,68.01,744,87.22,109,12.78,853
1,QLD,159,Pacific Pines North (Fadden),236,33.29,473,66.71,709,99.02,7,0.98,716
1,QLD,316,Pacific Pines North (Wright),183,31.61,396,68.39,579,98.3,10,1.7,589
1,QLD,156,Paddington,780,64.95,421,35.05,1201,99.26,9,0.74,1210
1,QLD,174,Pallara,908,45.65,1081,54.35,1989,99.15,17,0.85,2006
1,QLD,171,Palm Beach,620,44.48,774,55.52,1394,98.31,24,1.69,1418
1,QLD,171,Palm Beach North,724,44.44,905,55.56,1629,98.73,21,1.27,1650
1,QLD,171,Palm Beach South,602,47.4,668,52.6,1270,98.53,19,1.47,1289
1,QLD,168,Palm Cove,146,33.95,284,66.05,430,99.08,4,0.92,434
1,QLD,165,Palm Island,323,75.12,107,24.88,430,99.54,2,0.46,432
1,QLD,161,Palmview,483,38.8,762,61.2,1245,98.34,21,1.66,1266
1,QLD,161,Palmwoods,624,35.86,1116,64.14,1740,98.81,21,1.19,1761
1,QLD,159,Paradise Lakes,197,27.75,513,72.25,710,98.07,14,1.93,724
1,QLD,159,Paradise Point,356,27.15,955,72.85,1311,99.09,12,0.91,1323
1,QLD,157,Park Avenue,247,22.62,845,77.38,1092,99.27,8,0.73,1100
1,QLD,162,Park Ridge (Forde),500,28.36,1263,71.64,1763,98.22,32,1.78,1795
1,QLD,316,Park Ridge (Wright),68,28.45,171,71.55,239,98.76,3,1.24,242
1,QLD,157,Parkhurst,254,23.22,840,76.78,1094,98.74,14,1.26,1108
1,QLD,168,Parramatta Park,656,40.85,950,59.15,1606,98.71,21,1.29,1627
1,QLD,161,Peachester,143,28.77,354,71.23,497,98.03,10,1.97,507
1,QLD,316,Peak Crossing,104,21.05,390,78.95,494,99,5,1,499
1,QLD,161,Pelican Waters,552,30.46,1260,69.54,1812,99.29,13,0.71,1825
1,QLD,167,Pentland,6,6.45,87,93.55,93,100,0,0,93
1,QLD,178,Peregian Beach,332,60.69,215,39.31,547,98.92,6,1.08,553
1,QLD,160,Peregian Springs,623,43.14,821,56.86,1444,98.77,18,1.23,1462
1,QLD,170,Perseverance,57,23.65,184,76.35,241,99.18,2,0.82,243
1,QLD,252,Petrie,472,33.86,922,66.14,1394,98.59,20,1.41,1414
1,QLD,166,Pialba North,522,24.7,1591,75.3,2113,98.92,23,1.08,2136
1,QLD,170,Pilton,15,16.13,78,83.87,93,98.94,1,1.06,94
1,QLD,165,Pimlico,450,37.53,749,62.47,1199,99.01,12,0.99,1211
1,QLD,159,Pimpama (Fadden),149,37.63,247,62.37,396,99,4,1,400
1,QLD,162,Pimpama (Forde),251,30.57,570,69.43,821,98.8,10,1.2,831
1,QLD,159,Pimpama Central,737,35.76,1324,64.24,2061,98.47,32,1.53,2093
1,QLD,159,Pimpama East,398,37.37,667,62.63,1065,98.79,13,1.21,1078
1,QLD,304,Pine Mountain,164,25.23,486,74.77,650,98.93,7,1.07,657
1,QLD,164,Pittsworth,213,12.28,1521,87.72,1734,99.48,9,0.52,1743
1,QLD,316,Plainland,130,21.24,482,78.76,612,98.23,11,1.77,623
1,QLD,155,Point Lookout,149,39.52,228,60.48,377,98.69,5,1.31,382
1,QLD,178,Pomona,601,41.14,860,58.86,1461,98.85,17,1.15,1478
1,QLD,168,Pormpuraaw,153,55.84,121,44.16,274,98.92,3,1.08,277
1,QLD,168,Port Douglas,404,36.36,707,63.64,1111,99.37,7,0.63,1118
1,QLD,168,Port Douglas PPVC,768,27.33,2042,72.67,2810,99.36,18,0.64,2828
1,QLD,170,Pratten,16,13.11,106,86.89,122,99.19,1,0.81,123
1,QLD,158,Proserpine,170,19.38,707,80.62,877,99.1,8,0.9,885
1,QLD,158,Proserpine PPVC,745,14.9,4254,85.1,4999,99.38,31,0.62,5030
1,QLD,311,Proston,53,13.28,346,86.72,399,99.5,2,0.5,401
1,QLD,177,Pullenvale,417,46.49,480,53.51,897,99.01,9,0.99,906
1,QLD,158,Queens Beach,66,25.1,197,74.9,263,99.25,2,0.75,265
1,QLD,167,Queenton,39,8.9,399,91.1,438,99.77,1,0.23,439
1,QLD,170,Quilpie,30,11.95,221,88.05,251,99.6,1,0.4,252
1,QLD,164,Quinalow,15,6.73,208,93.27,223,99.55,1,0.45,224
1,QLD,304,Raceview,594,29.66,1409,70.34,2003,98.86,23,1.14,2026
1,QLD,304,Raceview West,329,32.8,674,67.2,1003,98.92,11,1.08,1014
1,QLD,165,Railway Estate,375,38.15,608,61.85,983,98.89,11,1.11,994
1,QLD,178,Rainbow Beach,145,24.7,442,75.3,587,98.99,6,1.01,593
1,QLD,177,Rainworth,1209,65.67,632,34.33,1841,99.3,13,0.7,1854
1,QLD,164,Rangeville,750,38.05,1221,61.95,1971,99.39,12,0.61,1983
1,QLD,164,Rangeville North,173,37.45,289,62.55,462,98.93,5,1.07,467
1,QLD,165,Rasmussen,341,22.72,1160,77.28,1501,99.01,15,0.99,1516
1,QLD,316,Rathdowney,36,15.86,191,84.14,227,99.56,1,0.44,228
1,QLD,167,Ravenshoe,170,18.05,772,81.95,942,99.05,9,0.95,951
1,QLD,304,Raymonds Hill,340,36.17,600,63.83,940,98.43,15,1.57,955
1,QLD,156,Red Hill,283,65.21,151,34.79,434,99.31,3,0.69,437
1,QLD,174,Redbank,158,37.89,259,62.11,417,98.82,5,1.18,422
1,QLD,304,Redbank Plains (Blair),916,43.68,1181,56.32,2097,98.54,31,1.46,2128
1,QLD,174,Redbank Plains (Oxley),238,42.96,316,57.04,554,98.23,10,1.77,564
1,QLD,304,Redbank Plains East (Blair),419,39.23,649,60.77,1068,98.16,20,1.84,1088
1,QLD,174,Redbank Plains East (Oxley),447,40.02,670,59.98,1117,98.59,16,1.41,1133
1,QLD,174,Redbank South,430,38.95,674,61.05,1104,98.84,13,1.16,1117
1,QLD,175,Redcliffe,650,36.66,1123,63.34,1773,98.99,18,1.01,1791
1,QLD,175,Redcliffe PPVC,3395,28.68,8441,71.32,11836,99.36,76,0.64,11912
1,QLD,175,Redcliffe South,427,39.07,666,60.93,1093,98.91,12,1.09,1105
1,QLD,155,Redland Bay,409,29.09,997,70.91,1406,98.87,16,1.13,1422
1,QLD,155,Redland Bay South,677,28.94,1662,71.06,2339,98.98,24,1.02,2363
1,QLD,168,Redlynch,636,32.24,1337,67.76,1973,99.2,16,0.8,1989
1,QLD,171,Reedy Creek,507,35.83,908,64.17,1415,98.74,18,1.26,1433
1,QLD,171,Reedy Creek MCPHERSON PPVC,2491,29.36,5992,70.64,8483,99.14,74,0.86,8557
1,QLD,172,Reedy Creek MONCRIEFF PPVC,157,29.62,373,70.38,530,98.7,7,1.3,537
1,QLD,171,Reedy Creek South,547,37.78,901,62.22,1448,99.18,12,0.82,1460
1,QLD,316,Reedy Creek WRIGHT PPVC,578,27.38,1533,72.62,2111,99.43,12,0.57,2123
1,QLD,176,Regents Park,551,32.8,1129,67.2,1680,98.71,22,1.29,1702
1,QLD,168,Remote Mobile Team 1,465,74.4,160,25.6,625,99.21,5,0.79,630
1,QLD,167,Remote Mobile Team 1,268,30.04,624,69.96,892,99.55,4,0.45,896
1,QLD,170,Remote Mobile Team 1,34,18.78,147,81.22,181,100,0,0,181
1,QLD,157,Remote Mobile Team 1,26,12.44,183,87.56,209,100,0,0,209
1,QLD,311,Remote Mobile Team 1,12,8.82,124,91.18,136,100,0,0,136
1,QLD,178,Remote Mobile Team 1,2,8.7,21,91.3,23,100,0,0,23
1,QLD,168,Remote Mobile Team 2,584,76.04,184,23.96,768,99.61,3,0.39,771
1,QLD,170,Remote Mobile Team 2,11,9.48,105,90.52,116,99.15,1,0.85,117
1,QLD,167,Remote Mobile Team 2,100,46.95,113,53.05,213,98.16,4,1.84,217
1,QLD,168,Remote Mobile Team 3,185,73.41,67,26.59,252,99.21,2,0.79,254
1,QLD,170,Remote Mobile Team 3,7,24.14,22,75.86,29,100,0,0,29
1,QLD,167,Remote Mobile Team 3,12,15.38,66,84.62,78,100,0,0,78
1,QLD,168,Remote Mobile Team 4,726,52.69,652,47.31,1378,99.21,11,0.79,1389
1,QLD,168,Remote Mobile Team 5,69,52.67,62,47.33,131,100,0,0,131
1,QLD,174,Richlands East,800,49.75,808,50.25,1608,98.05,32,1.95,1640
1,QLD,167,Richmond,23,8.19,258,91.81,281,100,0,0,281
1,QLD,167,Richmond Hill,84,24.71,256,75.29,340,99.42,2,0.58,342
1,QLD,304,Ripley Valley,493,42.76,660,57.24,1153,99.31,8,0.69,1161
1,QLD,166,River Heads,123,16.21,636,83.79,759,99.09,7,0.91,766
1,QLD,304,Riverview,350,37.63,580,62.37,930,98.2,17,1.8,947
1,QLD,316,Roadvale,49,15.56,266,84.44,315,100,0,0,315
1,QLD,173,Robertson,379,42.06,522,57.94,901,99.01,9,0.99,910
1,QLD,171,Robina,744,35.68,1341,64.32,2085,99,21,1,2106
1,QLD,171,Robina North,243,30.84,545,69.16,788,99.37,5,0.63,793
1,QLD,171,Robina West,731,36.51,1271,63.49,2002,98.33,34,1.67,2036
1,QLD,310,Rochedale (Bonner),663,40.83,961,59.17,1624,99.33,11,0.67,1635
1,QLD,176,Rochedale (Rankin),127,45.2,154,54.8,281,98.6,4,1.4,285
1,QLD,176,Rochedale South,516,41.68,722,58.32,1238,98.57,18,1.43,1256
1,QLD,157,Rockhampton CAPRICORNIA PPVC,3365,18.62,14703,81.38,18068,99.35,118,0.65,18186
1,QLD,157,Rockhampton City,425,25.53,1240,74.47,1665,98.58,24,1.42,1689
1,QLD,311,Rockhampton FLYNN PPVC,287,11.74,2158,88.26,2445,99.55,11,0.45,2456
1,QLD,173,Rocklea,231,55.8,183,44.2,414,98.34,7,1.66,421
1,QLD,164,Rockville,164,22.97,550,77.03,714,98.62,10,1.38,724
1,QLD,310,Roles Hill,392,47.4,435,52.6,827,98.81,10,1.19,837
1,QLD,167,Rollingstone,87,15.68,468,84.32,555,98.75,7,1.25,562
1,QLD,170,Roma,138,16.47,700,83.53,838,99.76,2,0.24,840
1,QLD,170,Roma PPVC,317,11.77,2376,88.23,2693,99.48,14,0.52,2707
1,QLD,170,Roma South,146,19.86,589,80.14,735,99.32,5,0.68,740
1,QLD,311,Rosedale,40,11.2,317,88.8,357,99.72,1,0.28,358
1,QLD,304,Rosewood,394,22.7,1342,77.3,1736,99.26,13,0.74,1749
1,QLD,175,Rothwell,388,32.52,805,67.48,1193,98.6,17,1.4,1210
1,QLD,302,Rothwell LONGMAN PPVC,117,21.43,429,78.57,546,99.45,3,0.55,549
1,QLD,175,Rothwell PETRIE PPVC,2085,24.72,6349,75.28,8434,99.26,63,0.74,8497
1,QLD,311,Rubyvale,104,20.39,406,79.61,510,99.03,5,0.97,515
1,QLD,159,Runaway Bay,911,30.02,2124,69.98,3035,98.51,46,1.49,3081
1,QLD,159,Runaway Bay FADDEN PPVC,3356,19.51,13846,80.49,17202,99.31,120,0.69,17322
1,QLD,172,Runaway Bay MONCRIEFF PPVC,158,22.1,557,77.9,715,98.48,11,1.52,726
1,QLD,173,Runcorn,399,43.28,523,56.72,922,99.46,5,0.54,927
1,QLD,173,Runcorn East,509,43.8,653,56.2,1162,99.23,9,0.77,1171
1,QLD,173,Runcorn Heights (Moreton),805,43.7,1037,56.3,1842,98.98,19,1.02,1861
1,QLD,176,Runcorn Heights (Rankin),140,41.54,197,58.46,337,97.68,8,2.32,345
1,QLD,155,Russell Island,538,30.97,1199,69.03,1737,98.69,23,1.31,1760
1,QLD,304,Sadliers Crossing,445,37.55,740,62.45,1185,99.33,8,0.67,1193
1,QLD,173,Salisbury,1125,59.18,776,40.82,1901,99.06,18,0.94,1919
1,QLD,252,Samford,377,43.58,488,56.42,865,99.31,6,0.69,871
1,QLD,252,Samford Central,742,46.64,849,53.36,1591,99.13,14,0.87,1605
1,QLD,252,Samford PPVC,1708,36.5,2971,63.5,4679,99.22,37,0.78,4716
1,QLD,169,Sandgate,898,51.28,853,48.72,1751,98.7,23,1.3,1774
1,QLD,302,Sandstone Point,186,22.82,629,77.18,815,98.19,15,1.81,830
1,QLD,157,Sarina North,201,14.79,1158,85.21,1359,99.05,13,0.95,1372
1,QLD,157,Sarina PPVC,461,12.34,3274,87.66,3735,99.6,15,0.4,3750
1,QLD,157,Sarina South,25,12.02,183,87.98,208,100,0,0,208
1,QLD,175,Scarborough,529,39.89,797,60.11,1326,98.96,14,1.04,1340
1,QLD,175,Scarborough North,395,38.09,642,61.91,1037,99.71,3,0.29,1040
1,QLD,158,Seaforth,117,17.13,566,82.87,683,98.41,11,1.59,694
1,QLD,174,Serviceton South,654,48.12,705,51.88,1359,98.69,18,1.31,1377
1,QLD,163,Seven Hills,690,63.42,398,36.58,1088,98.73,14,1.27,1102
1,QLD,174,Seventeen Mile Rocks,933,52.92,830,47.08,1763,98.93,19,1.07,1782
1,QLD,162,Shailer Park,361,37.84,593,62.16,954,99.07,9,0.93,963
1,QLD,162,Shailer Park North,307,36.81,527,63.19,834,99.29,6,0.71,840
1,QLD,311,Sharon,89,16.04,466,83.96,555,99.46,3,0.54,558
1,QLD,173,Sherwood,918,61.24,581,38.76,1499,98.68,20,1.32,1519
1,QLD,169,Shorncliffe,610,55.96,480,44.04,1090,98.73,14,1.27,1104
1,QLD,304,Silkstone,769,36.72,1325,63.28,2094,98.77,26,1.23,2120
1,QLD,167,Silkwood,26,12.32,185,87.68,211,99.06,2,0.94,213
1,QLD,173,Sinnamon Park MORETON PPVC,621,41.48,876,58.52,1497,99.47,8,0.53,1505
1,QLD,174,Sinnamon Park OXLEY PPVC,3434,35.98,6110,64.02,9544,99.12,85,0.88,9629
1,QLD,177,Sinnamon Park RYAN PPVC,402,39.68,611,60.32,1013,99.31,7,0.69,1020
1,QLD,161,Sippy Downs East,410,41,590,59,1000,99.21,8,0.79,1008
1,QLD,160,Sippy Downs West (Fairfax),218,47.08,245,52.92,463,98.72,6,1.28,469
1,QLD,161,Sippy Downs West (Fisher),406,36.88,695,63.12,1101,97.78,25,2.22,1126
1,QLD,162,Slacks Creek (Forde),241,39.31,372,60.69,613,99.03,6,0.97,619
1,QLD,176,Slacks Creek (Rankin),588,39.1,916,60.9,1504,99.34,10,0.66,1514
1,QLD,158,Slade Point,300,30.71,677,69.29,977,98.99,10,1.01,987
1,QLD,168,Smithfield,255,40.09,381,59.91,636,99.38,4,0.63,640
1,QLD,167,Soldiers Hill,64,23.44,209,76.56,273,99.64,1,0.36,274
1,QLD,169,Somerset Hills,507,54.4,425,45.6,932,99.04,9,0.96,941
1,QLD,304,Somerset Regional PPVC,237,19.17,999,80.83,1236,99.6,5,0.4,1241
1,QLD,163,South Brisbane,1059,62.29,641,37.71,1700,99.24,13,0.76,1713
1,QLD,311,South Gladstone,326,26.77,892,73.23,1218,99.27,9,0.73,1227
1,QLD,167,South Johnstone,61,19.87,246,80.13,307,97.77,7,2.23,314
1,QLD,311,South Kolan,46,10.04,412,89.96,458,100,0,0,458
1,QLD,167,South Mission Beach,164,31.72,353,68.28,517,98.85,6,1.15,523
1,QLD,164,South Toowoomba PPVC,2194,18.94,9390,81.06,11584,99.34,77,0.66,11661
1,QLD,164,Southbrook,51,12.85,346,87.15,397,99.25,3,0.75,400
1,QLD,171,Southern Gold Coast PPVC,4491,33.02,9110,66.98,13601,99.04,132,0.96,13733
1,QLD,172,Southport,685,41.09,982,58.91,1667,99.34,11,0.66,1678
1,QLD,172,Southport Central,545,41.29,775,58.71,1320,97.42,35,2.58,1355
1,QLD,159,Southport FADDEN PPVC,542,32.91,1105,67.09,1647,98.98,17,1.02,1664
1,QLD,171,Southport MCPHERSON PPVC,188,36.22,331,63.78,519,99.05,5,0.95,524
1,QLD,172,Southport MONCRIEFF PPVC,3435,32.27,7208,67.73,10643,99.22,84,0.78,10727
1,QLD,159,Southport North (Fadden),216,41.7,302,58.3,518,98.48,8,1.52,526
1,QLD,172,Southport North (Moncrieff),716,44.75,884,55.25,1600,98.83,19,1.17,1619
1,QLD,172,Southport West,161,42.71,216,57.29,377,99.47,2,0.53,379
1,QLD,178,Southside,492,20.67,1888,79.33,2380,99.13,21,0.87,2401
1,QLD,165,Special Hospital Team 1,123,31.46,268,68.54,391,94.67,22,5.33,413
1,QLD,176,Special Hospital Team 1,123,41.14,176,58.86,299,99.01,3,0.99,302
1,QLD,157,Special Hospital Team 1,91,30.03,212,69.97,303,98.7,4,1.3,307
1,QLD,304,Special Hospital Team 1,94,41.78,131,58.22,225,96.98,7,3.02,232
1,QLD,169,Special Hospital Team 1,64,50,64,50,128,99.22,1,0.78,129
1,QLD,174,Special Hospital Team 1,116,59.79,78,40.21,194,98.98,2,1.02,196
1,QLD,155,Special Hospital Team 1,144,58.78,101,41.22,245,91.42,23,8.58,268
1,QLD,171,Special Hospital Team 1,86,49.14,89,50.86,175,97.77,4,2.23,179
1,QLD,172,Special Hospital Team 1,36,37.5,60,62.5,96,100,0,0,96
1,QLD,302,Special Hospital Team 1,117,44.83,144,55.17,261,96.67,9,3.33,270
1,QLD,175,Special Hospital Team 1,122,38.49,195,61.51,317,96.35,12,3.65,329
1,QLD,164,Special Hospital Team 1,118,41.55,166,58.45,284,97.59,7,2.41,291
1,QLD,252,Special Hospital Team 1,87,47.8,95,52.2,182,99.45,1,0.55,183
1,QLD,170,Special Hospital Team 1,105,28.23,267,71.77,372,99.2,3,0.8,375
1,QLD,173,Special Hospital Team 1,83,43.68,107,56.32,190,97.44,5,2.56,195
1,QLD,177,Special Hospital Team 1,76,52.05,70,47.95,146,99.32,1,0.68,147
1,QLD,310,Special Hospital Team 1,71,61.21,45,38.79,116,97.48,3,2.52,119
1,QLD,163,Special Hospital Team 1,118,54.13,100,45.87,218,99.54,1,0.46,219
1,QLD,156,Special Hospital Team 1,36,52.94,32,47.06,68,98.55,1,1.45,69
1,QLD,311,Special Hospital Team 1,65,31.86,139,68.14,204,95.33,10,4.67,214
1,QLD,316,Special Hospital Team 1,30,48.39,32,51.61,62,93.94,4,6.06,66
1,QLD,161,Special Hospital Team 1,105,41.34,149,58.66,254,97.69,6,2.31,260
1,QLD,160,Special Hospital Team 1,106,46.29,123,53.71,229,98.71,3,1.29,232
1,QLD,158,Special Hospital Team 1,86,34.54,163,65.46,249,98.42,4,1.58,253
1,QLD,167,Special Hospital Team 1,153,92.73,12,7.27,165,100,0,0,165
1,QLD,166,Special Hospital Team 1,183,34.53,347,65.47,530,97.61,13,2.39,543
1,QLD,178,Special Hospital Team 1,97,33.22,195,66.78,292,95.74,13,4.26,305
1,QLD,159,Special Hospital Team 1,91,37.92,149,62.08,240,98.36,4,1.64,244
1,QLD,162,Special Hospital Team 1,92,53.18,81,46.82,173,95.58,8,4.42,181
1,QLD,168,Special Hospital Team 1,90,42.65,121,57.35,211,99.53,1,0.47,212
1,QLD,164,Special Hospital Team 2,69,25.27,204,74.73,273,98.91,3,1.09,276
1,QLD,175,Special Hospital Team 2,153,40.16,228,59.84,381,98.96,4,1.04,385
1,QLD,166,Special Hospital Team 2,151,37.19,255,62.81,406,95.75,18,4.25,424
1,QLD,158,Special Hospital Team 2,28,36.84,48,63.16,76,100,0,0,76
1,QLD,304,Special Hospital Team 2,97,41.63,136,58.37,233,98.73,3,1.27,236
1,QLD,316,Special Hospital Team 2,101,45.7,120,54.3,221,95.26,11,4.74,232
1,QLD,155,Special Hospital Team 2,96,37.65,159,62.35,255,98.08,5,1.92,260
1,QLD,302,Special Hospital Team 2,100,40.32,148,59.68,248,99.6,1,0.4,249
1,QLD,170,Special Hospital Team 2,92,31.51,200,68.49,292,94.5,17,5.5,309
1,QLD,163,Special Hospital Team 2,78,65,42,35,120,100,0,0,120
1,QLD,156,Special Hospital Team 2,28,34.15,54,65.85,82,97.62,2,2.38,84
1,QLD,160,Special Hospital Team 2,111,39.5,170,60.5,281,97.23,8,2.77,289
1,QLD,161,Special Hospital Team 2,103,44.21,130,55.79,233,97.9,5,2.1,238
1,QLD,169,Special Hospital Team 2,116,56.31,90,43.69,206,99.04,2,0.96,208
1,QLD,177,Special Hospital Team 2,56,57.14,42,42.86,98,98.99,1,1.01,99
1,QLD,178,Special Hospital Team 2,111,49.55,113,50.45,224,98.25,4,1.75,228
1,QLD,173,Special Hospital Team 2,60,61.86,37,38.14,97,98.98,1,1.02,98
1,QLD,176,Special Hospital Team 2,46,44.66,57,55.34,103,97.17,3,2.83,106
1,QLD,157,Special Hospital Team 2,92,37.1,156,62.9,248,98.02,5,1.98,253
1,QLD,311,Special Hospital Team 2,0,0,0,0,0,0,0,0, -   
1,QLD,168,Special Hospital Team 2,45,49.45,46,50.55,91,100,0,0,91
1,QLD,167,Special Hospital Team 2,32,27.35,85,72.65,117,98.32,2,1.68,119
1,QLD,159,Special Hospital Team 2,106,37.46,177,62.54,283,98.95,3,1.05,286
1,QLD,162,Special Hospital Team 2,111,53.37,97,46.63,208,97.2,6,2.8,214
1,QLD,171,Special Hospital Team 2,99,41.6,139,58.4,238,95.97,10,4.03,248
1,QLD,172,Special Hospital Team 2,50,31.65,108,68.35,158,97.53,4,2.47,162
1,QLD,310,Special Hospital Team 2,120,48,130,52,250,99.6,1,0.4,251
1,QLD,158,Special Hospital Team 3,8,16.33,41,83.67,49,100,0,0,49
1,QLD,164,Special Hospital Team 3,91,32.38,190,67.62,281,98.6,4,1.4,285
1,QLD,175,Special Hospital Team 3,87,45.08,106,54.92,193,94.15,12,5.85,205
1,QLD,302,Special Hospital Team 3,138,36.13,244,63.87,382,98.71,5,1.29,387
1,QLD,160,Special Hospital Team 3,52,35.62,94,64.38,146,97.33,4,2.67,150
1,QLD,161,Special Hospital Team 3,140,36.84,240,63.16,380,99.74,1,0.26,381
1,QLD,178,Special Hospital Team 3,79,35.59,143,64.41,222,99.11,2,0.89,224
1,QLD,157,Special Hospital Team 3,27,33.75,53,66.25,80,97.56,2,2.44,82
1,QLD,311,Special Hospital Team 3,12,46.15,14,53.85,26,100,0,0,26
1,QLD,316,Special Hospital Team 3,29,34.12,56,65.88,85,100,0,0,85
1,QLD,167,Special Hospital Team 3,17,22.37,59,77.63,76,98.7,1,1.3,77
1,QLD,155,Special Hospital Team 3,42,39.62,64,60.38,106,99.07,1,0.93,107
1,QLD,163,Special Hospital Team 3,29,45.31,35,54.69,64,100,0,0,64
1,QLD,156,Special Hospital Team 3,63,64.95,34,35.05,97,96.04,4,3.96,101
1,QLD,169,Special Hospital Team 3,78,56.12,61,43.88,139,100,0,0,139
1,QLD,177,Special Hospital Team 3,98,52.13,90,47.87,188,97.92,4,2.08,192
1,QLD,173,Special Hospital Team 3,24,40.68,35,59.32,59,93.65,4,6.35,63
1,QLD,176,Special Hospital Team 3,52,49.52,53,50.48,105,93.75,7,6.25,112
1,QLD,170,Special Hospital Team 3,37,33.33,74,66.67,111,100,0,0,111
1,QLD,158,Special Hospital Team 4,27,33.33,54,66.67,81,97.59,2,2.41,83
1,QLD,157,Special Hospital Team 4,4,28.57,10,71.43,14,100,0,0,14
1,QLD,311,Special Hospital Team 4,4,12.12,29,87.88,33,97.06,1,2.94,34
1,QLD,167,Special Hospital Team 4,0,0,0,0,0,0,0,0, -   
1,QLD,158,Special Hospital Team 5,62,36.26,109,63.74,171,100,0,0,171
1,QLD,311,Special Hospital Team 5,14,19.18,59,80.82,73,98.65,1,1.35,74
1,QLD,167,Special Hospital Team 5,25,43.86,32,56.14,57,91.94,5,8.06,62
1,QLD,311,Special Hospital Team 6,13,23.64,42,76.36,55,100,0,0,55
1,QLD,156,Spring Hill,543,63.14,317,36.86,860,99.54,4,0.46,864
1,QLD,316,Springbrook,125,41.67,175,58.33,300,99.01,3,0.99,303
1,QLD,174,Springfield,733,40.08,1096,59.92,1829,98.7,24,1.3,1853
1,QLD,304,Springfield Central,899,47.74,984,52.26,1883,99,19,1,1902
1,QLD,304,Springfield Central BLAIR PPVC,1751,35.79,3141,64.21,4892,99.35,32,0.65,4924
1,QLD,174,Springfield Central OXLEY PPVC,3119,31.93,6649,68.07,9768,99.35,64,0.65,9832
1,QLD,316,Springfield Central WRIGHT PPVC,196,24.56,602,75.44,798,99.01,8,0.99,806
1,QLD,304,Springfield Lakes (Blair),203,44.13,257,55.87,460,98.5,7,1.5,467
1,QLD,174,Springfield Lakes (Oxley),1179,43.22,1549,56.78,2728,98.63,38,1.37,2766
1,QLD,311,Springsure,48,9.04,483,90.96,531,99.25,4,0.75,535
1,QLD,310,Springwood BONNER PPVC,148,32.39,309,67.61,457,98.28,8,1.72,465
1,QLD,176,Springwood Central,358,44.53,446,55.47,804,98.41,13,1.59,817
1,QLD,176,Springwood East,147,45.79,174,54.21,321,97.87,7,2.13,328
1,QLD,162,Springwood FORDE PPVC,358,26.11,1013,73.89,1371,99.28,10,0.72,1381
1,QLD,173,Springwood MORETON PPVC,705,38.01,1150,61.99,1855,98.93,20,1.07,1875
1,QLD,176,Springwood RANKIN PPVC,2493,31.89,5325,68.11,7818,99.24,60,0.76,7878
1,QLD,176,Springwood Road,918,43.02,1216,56.98,2134,98.66,29,1.34,2163
1,QLD,170,St George,77,18.12,348,81.88,425,99.07,4,0.93,429
1,QLD,170,St George PPVC,191,17.8,882,82.2,1073,99.54,5,0.46,1078
1,QLD,177,St Lucia,554,64.95,299,35.05,853,98.61,12,1.39,865
1,QLD,156,Stafford,400,54.95,328,45.05,728,99.05,7,0.95,735
1,QLD,156,Stafford BRISBANE PPVC,1262,44.74,1559,55.26,2821,99.44,16,0.56,2837
1,QLD,169,Stafford Central,499,50.46,490,49.54,989,98.51,15,1.49,1004
1,QLD,252,Stafford DICKSON PPVC,445,34.87,831,65.13,1276,99.45,7,0.55,1283
1,QLD,169,Stafford Heights,709,47.27,791,52.73,1500,98.68,20,1.32,1520
1,QLD,169,Stafford LILLEY PPVC,4117,41.96,5694,58.04,9811,99.41,58,0.59,9869
1,QLD,175,Stafford PETRIE PPVC,195,31.86,417,68.14,612,99.67,2,0.33,614
1,QLD,177,Stafford RYAN PPVC,721,48.29,772,51.71,1493,98.48,23,1.52,1516
1,QLD,156,Stafford West (Brisbane),101,63.92,57,36.08,158,98.14,3,1.86,161
1,QLD,169,Stafford West (Lilley),205,58.4,146,41.6,351,99.43,2,0.57,353
1,QLD,170,Stanthorpe,328,25.83,942,74.17,1270,99.22,10,0.78,1280
1,QLD,170,Stanthorpe PPVC,856,21.1,3201,78.9,4057,99.51,20,0.49,4077
1,QLD,311,Stanwell,23,10.7,192,89.3,215,100,0,0,215
1,QLD,163,Stones Corner,1027,66.34,521,33.66,1548,99.29,11,0.71,1559
1,QLD,168,Stratford,320,44.08,406,55.92,726,98.24,13,1.76,739
1,QLD,252,Strathpine,596,38.45,954,61.55,1550,98.98,16,1.02,1566
1,QLD,252,Strathpine DICKSON PPVC,3499,27.04,9439,72.96,12938,99.26,96,0.74,13034
1,QLD,175,Strathpine PETRIE PPVC,780,28.62,1945,71.38,2725,99.63,10,0.37,2735
1,QLD,252,Strathpine West,446,35.12,824,64.88,1270,98.07,25,1.93,1295
1,QLD,176,Stretton,1141,42.62,1536,57.38,2677,99.41,16,0.59,2693
1,QLD,159,Studio Village (Fadden),197,32.08,417,67.92,614,97.77,14,2.23,628
1,QLD,316,Studio Village (Wright),220,30.99,490,69.01,710,98.89,8,1.11,718
1,QLD,173,Sunnybank,509,44.57,633,55.43,1142,98.79,14,1.21,1156
1,QLD,173,Sunnybank Hills,930,39.16,1445,60.84,2375,97.98,49,2.02,2424
1,QLD,167,Sunset,119,32.6,246,67.4,365,99.46,2,0.54,367
1,QLD,170,Surat,40,13.89,248,86.11,288,100,0,0,288
1,QLD,172,Surfers Paradise,427,37.23,720,62.77,1147,98.71,15,1.29,1162
1,QLD,172,Surfers Paradise PPVC,1101,26.43,3064,73.57,4165,98.84,49,1.16,4214
1,QLD,170,Taabinga,109,21.21,405,78.79,514,99.23,4,0.77,518
1,QLD,169,Taigum,653,48.19,702,51.81,1355,98.76,17,1.24,1372
1,QLD,171,Tallai (McPherson),497,34.42,947,65.58,1444,98.9,16,1.1,1460
1,QLD,316,Tallai (Wright),432,31.21,952,68.79,1384,99.14,12,0.86,1396
1,QLD,171,Tallebudgera,618,36.35,1082,63.65,1700,98.27,30,1.73,1730
1,QLD,170,Talwood,13,14.44,77,85.56,90,100,0,0,90
1,QLD,170,Tambo,26,11.5,200,88.5,226,100,0,0,226
1,QLD,316,Tamborine,312,25.04,934,74.96,1246,98.5,19,1.5,1265
1,QLD,316,Tamborine Mountain,460,40.21,684,59.79,1144,99.22,9,0.78,1153
1,QLD,316,Tamborine North,781,43.01,1035,56.99,1816,98.7,24,1.3,1840
1,QLD,316,Tamrookum,22,14.97,125,85.03,147,98.66,2,1.34,149
1,QLD,168,Tamwoy,94,74.02,33,25.98,127,100,0,0,127
1,QLD,311,Tannum Sands,175,28.83,432,71.17,607,99.67,2,0.33,609
1,QLD,162,Tansey Park,103,40.08,154,59.92,257,99.23,2,0.77,259
1,QLD,170,Tara,133,15.34,734,84.66,867,98.97,9,1.03,876
1,QLD,304,Tarampa,79,14.6,462,85.4,541,99.63,2,0.37,543
1,QLD,157,Taranganba,415,31.46,904,68.54,1319,98.88,15,1.12,1334
1,QLD,177,Taringa,582,66.21,297,33.79,879,99.43,5,0.57,884
1,QLD,311,Taroom,27,6.94,362,93.06,389,99.23,3,0.77,392
1,QLD,173,Tarragindi,881,62.09,538,37.91,1419,98.75,18,1.25,1437
1,QLD,173,Tarragindi East,695,61.34,438,38.66,1133,99.56,5,0.44,1138
1,QLD,156,Teneriffe,1084,66.26,552,33.74,1636,98.79,20,1.21,1656
1,QLD,178,Tewantin,672,40.29,996,59.71,1668,98.52,25,1.48,1693
1,QLD,160,Tewantin FAIRFAX PPVC,778,38.03,1268,61.97,2046,99.42,12,0.58,2058
1,QLD,178,Tewantin South,190,48.22,204,51.78,394,98.25,7,1.75,401
1,QLD,178,Tewantin WIDE BAY PPVC,5030,30.94,11226,69.06,16256,99.18,135,0.82,16391
1,QLD,170,Texas,69,15.72,370,84.28,439,99.32,3,0.68,442
1,QLD,166,Thabeban,223,19.06,947,80.94,1170,99.32,8,0.68,1178
1,QLD,311,Thangool,13,8.78,135,91.22,148,100,0,0,148
1,QLD,170,Thargomindah,11,10.58,93,89.42,104,100,0,0,104
1,QLD,157,The Caves,97,12.76,663,87.24,760,99.35,5,0.65,765
1,QLD,177,The Gap,1034,63.09,605,36.91,1639,99.21,13,0.79,1652
1,QLD,156,The Gap BRISBANE PPVC,1385,54.31,1165,45.69,2550,99.42,15,0.58,2565
1,QLD,177,The Gap East,1215,64.49,669,35.51,1884,99.16,16,0.84,1900
1,QLD,177,The Gap RYAN PPVC,3374,46.71,3849,53.29,7223,99.38,45,0.62,7268
1,QLD,177,The Gap West,936,59.24,644,40.76,1580,99.25,12,0.75,1592
1,QLD,164,The Range,299,42.65,402,57.35,701,99.86,1,0.14,702
1,QLD,170,The Summit,40,17.09,194,82.91,234,98.73,3,1.27,237
1,QLD,165,The Weir,370,26.62,1020,73.38,1390,99.14,12,0.86,1402
1,QLD,311,Theodore,40,9.73,371,90.27,411,99.52,2,0.48,413
1,QLD,155,Thorneside,302,43.02,400,56.98,702,98.46,11,1.54,713
1,QLD,155,Thornlands,389,33.89,759,66.11,1148,99.14,10,0.86,1158
1,QLD,155,Thornlands PPVC,2337,22.77,7928,77.23,10265,99.3,72,0.7,10337
1,QLD,155,Thornlands South,236,34.35,451,65.65,687,99.13,6,0.87,693
1,QLD,316,Thornton,16,11.19,127,88.81,143,99.31,1,0.69,144
1,QLD,168,Thursday Island,262,72.38,100,27.62,362,99.18,3,0.82,365
1,QLD,168,Thursday Island PPVC,510,68.55,234,31.45,744,99.47,4,0.53,748
1,QLD,178,Tiaro,63,15.04,356,84.96,419,99.76,1,0.24,420
1,QLD,311,Tieri,33,17.93,151,82.07,184,98.92,2,1.08,186
1,QLD,178,Tin Can Bay,230,18.07,1043,81.93,1273,99.38,8,0.62,1281
1,QLD,178,Tinana,251,18.47,1108,81.53,1359,99.34,9,0.66,1368
1,QLD,178,Tinbeerwah,245,40.5,360,59.5,605,99.67,2,0.33,607
1,QLD,310,Tingalpa,1040,50.27,1029,49.73,2069,99.04,20,0.96,2089
1,QLD,304,Tivoli,334,29.56,796,70.44,1130,98.52,17,1.48,1147
1,QLD,167,Tolga,121,21.15,451,78.85,572,99.13,5,0.87,577
1,QLD,167,Toobanna,20,11.63,152,88.37,172,98.85,2,1.15,174
1,QLD,304,Toogoolawah,155,19.92,623,80.08,778,99.62,3,0.38,781
1,QLD,166,Toogoom,192,19.28,804,80.72,996,99.6,4,0.4,1000
1,QLD,302,Toorbul,79,18.81,341,81.19,420,99.06,4,0.94,424
1,QLD,177,Toowong,1557,64.74,848,35.26,2405,99.09,22,0.91,2427
1,QLD,177,Toowong West,576,67.61,276,32.39,852,99.3,6,0.7,858
1,QLD,164,Toowoomba City,164,38.86,258,61.14,422,99.06,4,0.94,426
1,QLD,164,Toowoomba East,651,45.97,765,54.03,1416,99.23,11,0.77,1427
1,QLD,164,Toowoomba PPVC,3059,26.88,8322,73.12,11381,99.41,68,0.59,11449
1,QLD,164,Toowoomba South,201,37.29,338,62.71,539,98.9,6,1.1,545
1,QLD,164,Toowoomba Taylor St,363,39.33,560,60.67,923,98.51,14,1.49,937
1,QLD,164,Toowoomba West,204,28.22,519,71.78,723,99.04,7,0.96,730
1,QLD,164,Tor Street North,263,25.1,785,74.9,1048,99.34,7,0.66,1055
1,QLD,166,Torbanlea,50,13.44,322,86.56,372,98.94,4,1.06,376
1,QLD,166,Torquay,356,26.31,997,73.69,1353,99.05,13,0.95,1366
1,QLD,158,Townsville DAWSON PPVC,517,17.88,2375,82.12,2892,99.42,17,0.58,2909
1,QLD,165,Townsville HERBERT PPVC,2349,23.64,7589,76.36,9938,99.51,49,0.49,9987
1,QLD,165,Townsville South,293,34.31,561,65.69,854,99.42,5,0.58,859
1,QLD,167,Trebonne,18,13.74,113,86.26,131,99.24,1,0.76,132
1,QLD,168,Trinity Beach,528,35.13,975,64.87,1503,98.95,16,1.05,1519
1,QLD,168,Trinity Park,495,32.85,1012,67.15,1507,98.95,16,1.05,1523
1,QLD,171,Tugun,1058,39.52,1619,60.48,2677,98.56,39,1.44,2716
1,QLD,167,Tully,110,21.91,392,78.09,502,98.24,9,1.76,511
1,QLD,167,Tully North,42,18.83,181,81.17,223,100,0,0,223
1,QLD,167,Tully PPVC,479,16.19,2479,83.81,2958,99.43,17,0.57,2975
1,QLD,171,Tweed Heads MCPHERSON PPVC,783,33.59,1548,66.41,2331,99.4,14,0.6,2345
1,QLD,177,Upper Brookfield,244,52.93,217,47.07,461,99.35,3,0.65,464
1,QLD,302,Upper Caboolture,162,23.96,514,76.04,676,98.98,7,1.02,683
1,QLD,162,Upper Coomera,523,28.67,1301,71.33,1824,99.02,18,0.98,1842
1,QLD,162,Upper Coomera North,739,29.44,1771,70.56,2510,97.7,59,2.3,2569
1,QLD,177,Upper Kedron,661,45.84,781,54.16,1442,99.31,10,0.69,1452
1,QLD,310,Upper Mt Gravatt (Bonner),798,48.22,857,51.78,1655,98.98,17,1.02,1672
1,QLD,173,Upper Mt Gravatt (Moreton),121,53.54,105,46.46,226,98.26,4,1.74,230
1,QLD,316,Upper Tenthill,37,14.02,227,85.98,264,99.25,2,0.75,266
1,QLD,166,Urangan,411,24.95,1236,75.05,1647,98.74,21,1.26,1668
1,QLD,166,Urangan West,314,22.4,1088,77.6,1402,98.87,16,1.13,1418
1,QLD,166,Urraween,302,23.41,988,76.59,1290,98.85,15,1.15,1305
1,QLD,171,Varsity Lakes,664,43.68,856,56.32,1520,98.83,18,1.17,1538
1,QLD,171,Varsity Lakes Central,710,39.1,1106,60.9,1816,98.27,32,1.73,1848
1,QLD,171,Varsity Lakes South,522,37.55,868,62.45,1390,97.75,32,2.25,1422
1,QLD,178,Veteran,73,19.57,300,80.43,373,99.2,3,0.8,376
1,QLD,167,Victoria Estate,9,7.76,107,92.24,116,99.15,1,0.85,117
1,QLD,155,Victoria Point,587,27.26,1566,72.74,2153,98.85,25,1.15,2178
1,QLD,155,Victoria Point Central,229,31.89,489,68.11,718,99.31,5,0.69,723
1,QLD,155,Victoria Point South,188,27.01,508,72.99,696,98.72,9,1.28,705
1,QLD,155,Vienna Woods,443,32.45,922,67.55,1365,98.63,19,1.37,1384
1,QLD,165,Vincent,286,31.6,619,68.4,905,99.02,9,0.98,914
1,QLD,169,Virginia,1047,54.65,869,45.35,1916,99.64,7,0.36,1923
1,QLD,167,Walkamin,17,15.6,92,84.4,109,98.2,2,1.8,111
1,QLD,157,Walkerston,226,16.04,1183,83.96,1409,99.51,7,0.49,1416
1,QLD,166,Walkervale,245,24.28,764,75.72,1009,98.92,11,1.08,1020
1,QLD,170,Wallangarra,46,22.66,157,77.34,203,98.07,4,1.93,207
1,QLD,311,Wallaville,41,11.71,309,88.29,350,99.72,1,0.28,351
1,QLD,304,Walloon,288,20.5,1117,79.5,1405,99.57,6,0.43,1411
1,QLD,170,Wallumbilla,17,6.3,253,93.7,270,99.26,2,0.74,272
1,QLD,302,Wamuran,325,23.67,1048,76.33,1373,98.92,15,1.08,1388
1,QLD,157,Wandal,225,30.36,516,69.64,741,99.33,5,0.67,746
1,QLD,170,Wandoan,24,8.99,243,91.01,267,99.63,1,0.37,268
1,QLD,252,Warner West,701,35.89,1252,64.11,1953,98.99,20,1.01,1973
1,QLD,170,Warra,14,13.46,90,86.54,104,99.05,1,0.95,105
1,QLD,173,Warrigal,1064,40.7,1550,59.3,2614,98.75,33,1.25,2647
1,QLD,316,Warrill View,27,13.71,170,86.29,197,99.49,1,0.51,198
1,QLD,170,Warwick,198,25.55,577,74.45,775,98.85,9,1.15,784
1,QLD,170,Warwick East,173,22.61,592,77.39,765,99.35,5,0.65,770
1,QLD,170,Warwick PPVC,1308,14.66,7617,85.34,8925,99.52,43,0.48,8968
1,QLD,170,Warwick South,151,18.08,684,81.92,835,98.7,11,1.3,846
1,QLD,170,Warwick West,120,19.14,507,80.86,627,99.21,5,0.79,632
1,QLD,162,Waterford,372,34.83,696,65.17,1068,98.43,17,1.57,1085
1,QLD,162,Waterford West,513,35.14,947,64.86,1460,98.18,27,1.82,1487
1,QLD,169,Wavell Heights,544,50.37,536,49.63,1080,99.08,10,0.92,1090
1,QLD,168,Weipa,255,26.81,696,73.19,951,99.17,8,0.83,959
1,QLD,164,Wellcamp,64,18.66,279,81.34,343,99.71,1,0.29,344
1,QLD,173,Wellers Hill,1037,62.43,624,37.57,1661,98.93,18,1.07,1679
1,QLD,155,Wellington Point,363,37.89,595,62.11,958,99.38,6,0.62,964
1,QLD,155,Wellington Point West,527,34.04,1021,65.96,1548,99.29,11,0.71,1559
1,QLD,163,West End,2008,69.46,883,30.54,2891,99.04,28,0.96,2919
1,QLD,156,West End BRISBANE PPVC,750,67.45,362,32.55,1112,99.73,3,0.27,1115
1,QLD,163,West End GRIFFITH PPVC,4540,60.36,2981,39.64,7521,99.26,56,0.74,7577
1,QLD,173,West End MORETON PPVC,1209,64.21,674,35.79,1883,99.31,13,0.69,1896
1,QLD,311,West Gladstone,198,26.02,563,73.98,761,99.61,3,0.39,764
1,QLD,311,West Gladstone South,219,27.41,580,72.59,799,98.64,11,1.36,810
1,QLD,304,West Ipswich,143,40.4,211,59.6,354,98.88,4,1.12,358
1,QLD,157,West Rockhampton,156,28.84,385,71.16,541,99.27,4,0.73,545
1,QLD,164,West Toowoomba PPVC,901,14.37,5369,85.63,6270,99.46,34,0.54,6304
1,QLD,164,Westbrook,157,17.14,759,82.86,916,99.67,3,0.33,919
1,QLD,156,Whinstanes,531,47.62,584,52.38,1115,99.64,4,0.36,1119
1,QLD,168,White Rock,395,34.5,750,65.5,1145,99.13,10,0.87,1155
1,QLD,163,Whites Hill,1056,56.05,828,43.95,1884,99.05,18,0.95,1902
1,QLD,168,Whitfield,507,40.99,730,59.01,1237,99.28,9,0.72,1246
1,QLD,178,Widgee,64,17.34,305,82.66,369,99.73,1,0.27,370
1,QLD,304,Willowbank,82,21.64,297,78.36,379,98.96,4,1.04,383
1,QLD,165,Willows,197,27.4,522,72.6,719,99.17,6,0.83,725
1,QLD,164,Wilsonton,187,22.16,657,77.84,844,97.8,19,2.2,863
1,QLD,164,Wilsonton Heights,232,25.44,680,74.56,912,99.13,8,0.87,920
1,QLD,156,Wilston,645,62.8,382,37.2,1027,99.42,6,0.58,1033
1,QLD,162,Windaroo,289,29.61,687,70.39,976,98.49,15,1.51,991
1,QLD,162,Windaroo Valley,502,28.28,1273,71.72,1775,98.61,25,1.39,1800
1,QLD,156,Windsor North,1549,66.71,773,33.29,2322,99.1,21,0.9,2343
1,QLD,170,Winton,27,16.36,138,83.64,165,97.63,4,2.37,169
1,QLD,170,Winton PPVC,53,12.27,379,87.73,432,99.77,1,0.23,433
1,QLD,310,Wishart,830,50.36,818,49.64,1648,99.34,11,0.66,1659
1,QLD,316,Withcott,235,20.51,911,79.49,1146,99.57,5,0.43,1151
1,QLD,161,Witta,111,40.07,166,59.93,277,99.64,1,0.36,278
1,QLD,178,Wolvi,51,23.83,163,76.17,214,98.62,3,1.38,217
1,QLD,311,Wondai,171,16.83,845,83.17,1016,99.71,3,0.29,1019
1,QLD,310,Wondall Heights,650,42.02,897,57.98,1547,98.79,19,1.21,1566
1,QLD,168,Wonga Beach,82,19.16,346,80.84,428,99.53,2,0.47,430
1,QLD,302,Woodford,444,21.92,1582,78.08,2026,98.83,24,1.17,2050
1,QLD,166,Woodgate,130,18.23,583,81.77,713,99.72,2,0.28,715
1,QLD,316,Woodhill,129,20.61,497,79.39,626,99.37,4,0.63,630
1,QLD,176,Woodridge,580,51.19,553,48.81,1133,97.84,25,2.16,1158
1,QLD,176,Woodridge East,420,42.64,565,57.36,985,98.6,14,1.4,999
1,QLD,162,Woodridge FORDE PPVC,866,28.57,2165,71.43,3031,99.18,25,0.82,3056
1,QLD,173,Woodridge MORETON PPVC,166,42.24,227,57.76,393,100,0,0,393
1,QLD,176,Woodridge North,506,46.98,571,53.02,1077,98.18,20,1.82,1097
1,QLD,176,Woodridge RANKIN PPVC,2610,31.64,5638,68.36,8248,98.84,97,1.16,8345
1,QLD,167,Woodstock,30,9.26,294,90.74,324,99.69,1,0.31,325
1,QLD,175,Woody Point North,583,38.23,942,61.77,1525,99.28,11,0.72,1536
1,QLD,163,Woolloongabba South,872,65.27,464,34.73,1336,98.96,14,1.04,1350
1,QLD,160,Woombye (Fairfax),407,36.27,715,63.73,1122,98.51,17,1.49,1139
1,QLD,161,Woombye (Fisher),181,32.26,380,67.74,561,98.42,9,1.58,570
1,QLD,166,Woongarra,61,16.49,309,83.51,370,100,0,0,370
1,QLD,159,Woongoolba,63,14.13,383,85.87,446,98.89,5,1.11,451
1,QLD,311,Woorabinda,116,49.36,119,50.64,235,98.33,4,1.67,239
1,QLD,302,Woorim,99,38.22,160,61.78,259,100,0,0,259
1,QLD,170,Wooroolin,16,11.51,123,88.49,139,98.58,2,1.42,141
1,QLD,168,Woree,464,33.29,930,66.71,1394,97.96,29,2.04,1423
1,QLD,172,Worongary,201,33.22,404,66.78,605,99.18,5,0.82,610
1,QLD,316,Worongary South,76,33.33,152,66.67,228,96.61,8,3.39,236
1,QLD,311,Wowan,15,7.39,188,92.61,203,100,0,0,203
1,QLD,158,Wulguru (Dawson),483,29.52,1153,70.48,1636,99.51,8,0.49,1644
1,QLD,167,Wulguru (Kennedy),44,18.03,200,81.97,244,99.59,1,0.41,245
1,QLD,310,Wynnum BONNER PPVC,5479,33.57,10840,66.43,16319,99.24,125,0.76,16444
1,QLD,310,Wynnum Central,998,45.74,1184,54.26,2182,99.09,20,0.91,2202
1,QLD,163,Wynnum GRIFFITH PPVC,397,41.57,558,58.43,955,99.07,9,0.93,964
1,QLD,310,Wynnum North,799,52.95,710,47.05,1509,99.15,13,0.85,1522
1,QLD,310,Wynnum South,290,51.42,274,48.58,564,99.65,2,0.35,566
1,QLD,310,Wynnum West,683,41.52,962,58.48,1645,97.92,35,2.08,1680
1,QLD,164,Wyreema,117,15.52,637,84.48,754,98.95,8,1.05,762
1,QLD,304,Yamanto,375,26.28,1052,73.72,1427,98.89,16,1.11,1443
1,QLD,311,Yandaran,43,11.68,325,88.32,368,98.92,4,1.08,372
1,QLD,160,Yandina,585,33.37,1168,66.63,1753,98.43,28,1.57,1781
1,QLD,170,Yangan,49,17.82,226,82.18,275,99.64,1,0.36,276
1,QLD,167,Yarrabah,502,75.72,161,24.28,663,99.55,3,0.45,666
1,QLD,316,Yarrabilba,568,30.72,1281,69.28,1849,98.77,23,1.23,1872
1,QLD,170,Yarraman,93,19.66,380,80.34,473,98.95,5,1.05,478
1,QLD,166,Yarrilee,348,21.82,1247,78.18,1595,98.82,19,1.18,1614
1,QLD,311,Yarwun,26,17.81,120,82.19,146,99.32,1,0.68,147
1,QLD,170,Yelarbon,17,10.63,143,89.38,160,100,0,0,160
1,QLD,157,Yeppoon,638,27.65,1669,72.35,2307,98.8,28,1.2,2335
1,QLD,157,Yeppoon PPVC,2215,19.02,9432,80.98,11647,99.42,68,0.58,11715
1,QLD,173,Yeronga,1260,66.39,638,33.61,1898,98.91,21,1.09,1919
1,QLD,173,Yeronga West,959,56.54,737,43.46,1696,99.36,11,0.64,1707
1,QLD,168,Yorkeys Knob,310,37.76,511,62.24,821,98.44,13,1.56,834
1,QLD,167,Yungaburra,171,28.64,426,71.36,597,99.17,5,0.83,602
1,QLD,169,Zillmere,174,51.18,166,48.82,340,98.27,6,1.73,346
1,QLD,169,Zillmere North,360,50.78,349,49.22,709,98.61,10,1.39,719
