QuestionNo,StateAb,DivisionID,PollingPlaceNm,YesVotes,YesPercentage,NoVotes,NoPercentage,FormalVotes,FormalPercentage,InformalVotes,InformalPercentage,TotalVotes
1,VIC,228,Abbotsford,763,83.3,153,16.7,916,99.13,8,0.87,924
1,VIC,320,Abbotsford COOPER PPVC,877,87.18,129,12.82,1006,99.41,6,0.59,1012
1,VIC,221,Abbotsford KOOYONG PPVC,2187,67.98,1030,32.02,3217,99.66,11,0.34,3228
1,VIC,228,Abbotsford MELBOURNE PPVC,10366,78.71,2804,21.29,13170,99.38,82,0.62,13252
1,VIC,228,Abbotsford South,867,85.42,148,14.58,1015,99.02,10,0.98,1025
1,VIC,234,Abbotsford WILLS PPVC,421,88.26,56,11.74,477,99.58,2,0.42,479
1,VIC,225,Aberfeldie,724,56.52,557,43.48,1281,99.46,7,0.54,1288
1,VIC,309,Aintree,1094,52.8,978,47.2,2072,99.52,10,0.48,2082
1,VIC,233,Aireys Inlet,437,76.8,132,23.2,569,99.65,2,0.35,571
1,VIC,225,Airport West,980,40.56,1436,59.44,2416,98.65,33,1.35,2449
1,VIC,203,Aitken Creek,860,50.35,848,49.65,1708,98.84,20,1.16,1728
1,VIC,212,Alamanda,895,54.24,755,45.76,1650,99.58,7,0.42,1657
1,VIC,322,Albert Park,842,67.31,409,32.69,1251,99.36,8,0.64,1259
1,VIC,213,Alberton,93,21.68,336,78.32,429,99.31,3,0.69,432
1,VIC,321,Albion,730,58.73,513,41.27,1243,97.64,30,2.36,1273
1,VIC,218,Albury INDI PPVC,379,37.9,621,62.1,1000,99.4,6,0.6,1006
1,VIC,218,Alexandra,386,29.76,911,70.24,1297,99.16,11,0.84,1308
1,VIC,322,Alfred Square,1164,79.62,298,20.38,1462,98.58,21,1.42,1483
1,VIC,198,Alfredton,435,43.63,562,56.37,997,98.71,13,1.29,1010
1,VIC,198,Alfredton West,1016,46.44,1172,53.56,2188,98.83,26,1.17,2214
1,VIC,233,Allansford,210,29.87,493,70.13,703,99.58,3,0.42,706
1,VIC,320,Alphington,1095,78.95,292,21.05,1387,99.28,10,0.72,1397
1,VIC,212,Altona,789,57.26,589,42.74,1378,98.57,20,1.43,1398
1,VIC,212,Altona Bay,330,45.14,401,54.86,731,98.38,12,1.62,743
1,VIC,212,Altona Gate,680,51.55,639,48.45,1319,98.8,16,1.2,1335
1,VIC,212,Altona Green,1035,47.43,1147,52.57,2182,98.51,33,1.49,2215
1,VIC,212,Altona Lakes,389,51.87,361,48.13,750,98.17,14,1.83,764
1,VIC,212,Altona Meadows,742,50.44,729,49.56,1471,98.53,22,1.47,1493
1,VIC,212,Altona Meadows East,338,48.56,358,51.44,696,98.58,10,1.42,706
1,VIC,212,Altona North,585,46.06,685,53.94,1270,98.37,21,1.63,1291
1,VIC,212,Altona West,778,56.13,608,43.87,1386,98.72,18,1.28,1404
1,VIC,208,Anakie,82,24.62,251,75.38,333,98.81,4,1.19,337
1,VIC,233,Anglesea,651,70.99,266,29.01,917,99.35,6,0.65,923
1,VIC,209,Antonio Park (Deakin),284,63.11,166,36.89,450,98.68,6,1.32,456
1,VIC,229,Antonio Park (Menzies),385,57.89,280,42.11,665,99.11,6,0.89,671
1,VIC,233,Apollo Bay,568,59.29,390,40.71,958,98.66,13,1.34,971
1,VIC,224,Apsley,58,21.56,211,78.44,269,99.26,2,0.74,271
1,VIC,233,Ararat,219,24.12,689,75.88,908,98.91,10,1.09,918
1,VIC,233,Ararat PPVC,780,24.44,2411,75.56,3191,99.28,23,0.72,3214
1,VIC,233,Ararat West,222,29.21,538,70.79,760,98.57,11,1.43,771
1,VIC,323,Arawata,52,22.61,178,77.39,230,99.14,2,0.86,232
1,VIC,324,Ardmona,84,22.76,285,77.24,369,98.93,4,1.07,373
1,VIC,215,Armadale,728,67.47,351,32.53,1079,99.63,4,0.37,1083
1,VIC,215,Armadale Central,358,73.97,126,26.03,484,99.59,2,0.41,486
1,VIC,215,Armadale North,383,62.48,230,37.52,613,99.35,4,0.65,617
1,VIC,328,Armstrong Creek East,955,57.25,713,42.75,1668,98.99,17,1.01,1685
1,VIC,226,Arthurs Creek,166,39.24,257,60.76,423,100,0,0,423
1,VIC,225,Ascot Vale,510,75.67,164,24.33,674,99.26,5,0.74,679
1,VIC,225,Ascot Vale Central,904,70.85,372,29.15,1276,98.99,13,1.01,1289
1,VIC,225,Ascot Vale East,1024,76.36,317,23.64,1341,98.75,17,1.25,1358
1,VIC,225,Ascot Vale West,550,75.65,177,24.35,727,98.91,8,1.09,735
1,VIC,215,Ashburton (Higgins),782,63.32,453,36.68,1235,98.48,19,1.52,1254
1,VIC,221,Ashburton (Kooyong),287,64.21,160,35.79,447,99.55,2,0.45,449
1,VIC,205,Ashburton CHISHOLM PPVC,1280,51.82,1190,48.18,2470,99.32,17,0.68,2487
1,VIC,215,Ashburton HIGGINS PPVC,3321,59.12,2296,40.88,5617,99.56,25,0.44,5642
1,VIC,221,Ashburton KOOYONG PPVC,703,57.39,522,42.61,1225,99.03,12,0.97,1237
1,VIC,322,Ashburton MACNAMARA PPVC,93,60,62,40,155,99.36,1,0.64,156
1,VIC,228,Ashburton MELBOURNE PPVC,55,71.43,22,28.57,77,100,0,0,77
1,VIC,215,Ashburton South,904,68.33,419,31.67,1323,98.81,16,1.19,1339
1,VIC,205,Ashwood,873,57.93,634,42.07,1507,98.95,16,1.05,1523
1,VIC,219,Aspendale,1126,63.33,652,36.67,1778,98.61,25,1.39,1803
1,VIC,219,Aspendale Central,324,55.48,260,44.52,584,99.15,5,0.85,589
1,VIC,219,Aspendale Gardens,685,51.43,647,48.57,1332,98.67,18,1.33,1350
1,VIC,203,Attwood,272,39.36,419,60.64,691,98.57,10,1.43,701
1,VIC,324,Avenel,141,35.7,254,64.3,395,99,4,1,399
1,VIC,224,Avoca,181,24.46,559,75.54,740,99.06,7,0.94,747
1,VIC,225,Avondale Heights,304,44.77,375,55.23,679,96.72,23,3.28,702
1,VIC,225,Avondale Heights Central,508,40.03,761,59.97,1269,98.68,17,1.32,1286
1,VIC,225,Avondale Heights West,173,43.14,228,56.86,401,99.26,3,0.74,404
1,VIC,200,Axe Creek,210,42.6,283,57.4,493,98.8,6,1.2,499
1,VIC,200,Axedale,184,29.02,450,70.98,634,99.06,6,0.94,640
1,VIC,326,Bacchus Marsh,471,44.14,596,55.86,1067,98.7,14,1.3,1081
1,VIC,326,Bacchus Marsh PPVC,2751,32.1,5818,67.9,8569,99.09,79,0.91,8648
1,VIC,204,Badger Creek,423,49.42,433,50.58,856,98.96,9,1.04,865
1,VIC,213,Bairnsdale,316,37.26,532,62.74,848,99.07,8,0.93,856
1,VIC,213,Bairnsdale PPVC,3443,24.84,10418,75.16,13861,99.26,103,0.74,13964
1,VIC,213,Bairnsdale West,389,35.49,707,64.51,1096,98.83,13,1.17,1109
1,VIC,322,Balaclava,942,76.34,292,23.66,1234,98.96,13,1.04,1247
1,VIC,326,Ballan,498,38.49,796,61.51,1294,98.7,17,1.3,1311
1,VIC,198,Ballarat,772,62.76,458,37.24,1230,98.56,18,1.44,1248
1,VIC,198,Ballarat BALLARAT PPVC,10690,35.93,19061,64.07,29751,99.09,273,0.91,30024
1,VIC,198,Ballarat East,661,60.53,431,39.47,1092,98.64,15,1.36,1107
1,VIC,198,Ballarat North,856,55.01,700,44.99,1556,99.17,13,0.83,1569
1,VIC,233,Ballarat WANNON PPVC,190,29.1,463,70.9,653,98.94,7,1.06,660
1,VIC,233,Balmoral,54,29.51,129,70.49,183,99.46,1,0.54,184
1,VIC,211,Balnarring,624,65.55,328,34.45,952,99.27,7,0.73,959
1,VIC,221,Balwyn,900,54.38,755,45.62,1655,99.16,14,0.84,1669
1,VIC,221,Balwyn North,1192,51.85,1107,48.15,2299,99.14,20,0.86,2319
1,VIC,221,Balwyn North Central,921,54.14,780,45.86,1701,99.24,13,0.76,1714
1,VIC,324,Bamawm,19,10.56,161,89.44,180,100,0,0,180
1,VIC,328,Bannockburn,558,34.62,1054,65.38,1612,98.96,17,1.04,1629
1,VIC,328,Bannockburn North,273,34.43,520,65.57,793,99.25,6,0.75,799
1,VIC,218,Baranduda,339,40.07,507,59.93,846,99.41,5,0.59,851
1,VIC,218,Barnawartha,131,27.46,346,72.54,477,99.17,4,0.83,481
1,VIC,328,Barwon CORANGAMITE PPVC,2408,39.14,3745,60.86,6153,98.97,64,1.03,6217
1,VIC,208,Barwon CORIO PPVC,9790,46.95,11062,53.05,20852,99.18,173,0.82,21025
1,VIC,328,Barwon Heads,884,66.02,455,33.98,1339,99.26,10,0.74,1349
1,VIC,233,Barwon WANNON PPVC,190,49.48,194,50.52,384,98.71,5,1.29,389
1,VIC,323,Bass,89,27.47,235,72.53,324,99.39,2,0.61,326
1,VIC,210,Baxter (Dunkley),195,33.91,380,66.09,575,98.97,6,1.03,581
1,VIC,211,Baxter (Flinders),326,41.96,451,58.04,777,98.85,9,1.15,786
1,VIC,223,Bayles,147,25,441,75,588,99.66,2,0.34,590
1,VIC,197,Bayswater,1018,50.55,996,49.45,2014,99.07,19,0.93,2033
1,VIC,209,Bayswater North,774,42.23,1059,57.77,1833,99.46,10,0.54,1843
1,VIC,197,Bayswater South,339,50.67,330,49.33,669,99.11,6,0.89,675
1,VIC,197,Bayswater West,558,45.15,678,54.85,1236,97.86,27,2.14,1263
1,VIC,328,Beacon Point,435,49.54,443,50.46,878,98.32,15,1.68,893
1,VIC,223,Beaconsfield,678,41.12,971,58.88,1649,98.57,24,1.43,1673
1,VIC,223,Beaconsfield Upper,419,39.2,650,60.8,1069,99.63,4,0.37,1073
1,VIC,224,Bealiba,27,20.77,103,79.23,130,99.24,1,0.76,131
1,VIC,233,Beaufort,285,26.32,798,73.68,1083,99.18,9,0.82,1092
1,VIC,214,Beaumaris,658,56.92,498,43.08,1156,98.72,15,1.28,1171
1,VIC,214,Beaumaris Central,858,54.55,715,45.45,1573,99.24,12,0.76,1585
1,VIC,214,Beaumaris North,658,61.44,413,38.56,1071,99.35,7,0.65,1078
1,VIC,209,Bedford Park,495,59.93,331,40.07,826,98.69,11,1.31,837
1,VIC,233,Beeac,55,22.09,194,77.91,249,98.81,3,1.19,252
1,VIC,218,Beechworth,805,60.57,524,39.43,1329,99.11,12,0.89,1341
1,VIC,204,Belgrave,614,71.23,248,28.77,862,99.08,8,0.92,870
1,VIC,204,Belgrave South,959,52.61,864,47.39,1823,99.02,18,0.98,1841
1,VIC,320,Bell,1367,82.05,299,17.95,1666,99.05,16,0.95,1682
1,VIC,208,Bell Park,303,39.56,463,60.44,766,98.71,10,1.29,776
1,VIC,208,Bell Park South,237,48.87,248,51.13,485,98.98,5,1.02,490
1,VIC,208,Bell Post Hill,472,46.27,548,53.73,1020,98.74,13,1.26,1033
1,VIC,328,Bellbrae,508,74.93,170,25.07,678,99.41,4,0.59,682
1,VIC,222,Bellbridge,971,46.08,1136,53.92,2107,97.86,46,2.14,2153
1,VIC,221,Bellevue,585,47.91,636,52.09,1221,99.11,11,0.89,1232
1,VIC,220,Bellfield,768,64.16,429,35.84,1197,99.34,8,0.66,1205
1,VIC,208,Belmont,676,66.08,347,33.92,1023,98.94,11,1.06,1034
1,VIC,208,Belmont North,1461,59.83,981,40.17,2442,98.99,25,1.01,2467
1,VIC,323,Bena,111,28.76,275,71.24,386,99.23,3,0.77,389
1,VIC,218,Benalla,563,33.18,1134,66.82,1697,99.07,16,0.93,1713
1,VIC,218,Benalla PPVC,1852,27.2,4958,72.8,6810,99.1,62,0.9,6872
1,VIC,200,Bendigo,230,46.46,265,53.54,495,99,5,1,500
1,VIC,200,Bendigo BENDIGO PPVC,6732,39.64,10251,60.36,16983,99.23,131,0.77,17114
1,VIC,200,Bendigo Central,762,52.26,696,47.74,1458,98.65,20,1.35,1478
1,VIC,200,Bendigo Central PPVC,3691,36,6562,64,10253,99,104,1,10357
1,VIC,200,Bendigo East,339,46.12,396,53.88,735,99.06,7,0.94,742
1,VIC,224,Bendigo MALLEE PPVC,88,27.24,235,72.76,323,99.69,1,0.31,324
1,VIC,200,Bendigo North,398,38.75,629,61.25,1027,98.18,19,1.82,1046
1,VIC,205,Bennettswood,658,51.25,626,48.75,1284,99,13,1,1297
1,VIC,214,Bentleigh,1135,62.23,689,37.77,1824,98.7,24,1.3,1848
1,VIC,214,Bentleigh Central (Goldstein),308,52.38,280,47.62,588,98.66,8,1.34,596
1,VIC,217,Bentleigh Central (Hotham),616,51.94,570,48.06,1186,98.92,13,1.08,1199
1,VIC,217,Bentleigh East,569,55.73,452,44.27,1021,98.27,18,1.73,1039
1,VIC,214,Bentleigh South (Goldstein),382,53.06,338,46.94,720,99.31,5,0.69,725
1,VIC,217,Bentleigh South (Hotham),501,52.68,450,47.32,951,98.96,10,1.04,961
1,VIC,219,Bentleigh South (Isaacs),107,50.71,104,49.29,211,100,0,0,211
1,VIC,214,Bentleigh West,1191,59.17,822,40.83,2013,99.16,17,0.84,2030
1,VIC,201,Berwick (Bruce),146,43.2,192,56.8,338,98.54,5,1.46,343
1,VIC,223,Berwick (La Trobe),853,44.99,1043,55.01,1896,98.75,24,1.25,1920
1,VIC,201,Berwick BRUCE PPVC,4048,35.04,7504,64.96,11552,99.24,88,0.76,11640
1,VIC,204,Berwick CASEY PPVC,167,39.2,259,60.8,426,98.84,5,1.16,431
1,VIC,201,Berwick Central,461,50.83,446,49.17,907,98.05,18,1.95,925
1,VIC,223,Berwick Chase,1003,51.89,930,48.11,1933,98.98,20,1.02,1953
1,VIC,201,Berwick Fields (Bruce),1217,48.8,1277,51.2,2494,99.05,24,0.95,2518
1,VIC,223,Berwick Fields (La Trobe),416,52.13,382,47.87,798,99.75,2,0.25,800
1,VIC,216,Berwick HOLT PPVC,730,39.89,1100,60.11,1830,99.13,16,0.87,1846
1,VIC,223,Berwick LA TROBE PPVC,6053,36.25,10647,63.75,16700,99.17,139,0.83,16839
1,VIC,201,Berwick Lodge (Bruce),452,46.08,529,53.92,981,98.89,11,1.11,992
1,VIC,223,Berwick Lodge (La Trobe),110,46.22,128,53.78,238,98.76,3,1.24,241
1,VIC,201,Berwick North,917,44.47,1145,55.53,2062,98.85,24,1.15,2086
1,VIC,223,Berwick South,389,50.45,382,49.55,771,99.48,4,0.52,775
1,VIC,218,Bethanga,124,35.63,224,64.37,348,99.15,3,0.85,351
1,VIC,224,Beulah,26,11.45,201,88.55,227,99.56,1,0.44,228
1,VIC,224,Beverford,19,14.84,109,85.16,128,100,0,0,128
1,VIC,226,Beveridge,453,41.6,636,58.4,1089,98.37,18,1.63,1107
1,VIC,200,Big Hill,224,41.1,321,58.9,545,98.55,8,1.45,553
1,VIC,224,Birchip,123,23.65,397,76.35,520,99.81,1,0.19,521
1,VIC,233,Birregurra,270,57.08,203,42.92,473,98.95,5,1.05,478
1,VIC,211,Bittern,220,45.45,264,54.55,484,99.18,4,0.82,488
1,VIC,198,Black Hill,839,63.9,474,36.1,1313,99.09,12,0.91,1325
1,VIC,214,Black Rock,612,62.51,367,37.49,979,99.19,8,0.81,987
1,VIC,214,Black Rock South,908,55.81,719,44.19,1627,99.09,15,0.91,1642
1,VIC,205,Blackburn (Chisholm),508,62.64,303,37.36,811,99.51,4,0.49,815
1,VIC,209,Blackburn (Deakin),266,68.21,124,31.79,390,99.24,3,0.76,393
1,VIC,209,Blackburn Lake,892,63.76,507,36.24,1399,98.87,16,1.13,1415
1,VIC,229,Blackburn North,683,62.89,403,37.11,1086,99.09,10,0.91,1096
1,VIC,229,Blackburn North Heights,924,62.01,566,37.99,1490,99,15,1,1505
1,VIC,205,Blackburn South,1047,55.48,840,44.52,1887,98.8,23,1.2,1910
1,VIC,229,Blackburn Upper,677,58.16,487,41.84,1164,99.06,11,0.94,1175
1,VIC,229,Blackburn West,464,57.64,341,42.36,805,98.89,9,1.11,814
1,VIC,326,Blackwood,146,55.51,117,44.49,263,98.87,3,1.13,266
1,VIC,211,Blairgowrie,405,53.15,357,46.85,762,98.7,10,1.3,772
1,VIC,213,Boisdale,79,25.73,228,74.27,307,99.35,2,0.65,309
1,VIC,226,Bolinda,139,35.64,251,64.36,390,98.48,6,1.52,396
1,VIC,233,Bolwarra,90,31.25,198,68.75,288,98.63,4,1.37,292
1,VIC,323,Bona Vista,86,37.55,143,62.45,229,97.86,5,2.14,234
1,VIC,219,Bonbeach,803,57.81,586,42.19,1389,98.86,16,1.14,1405
1,VIC,218,Bonegilla,108,31.67,233,68.33,341,99.71,1,0.29,342
1,VIC,211,Boneo,194,57.23,145,42.77,339,99.41,2,0.59,341
1,VIC,218,Bonnie Doon,52,29.05,127,70.95,179,100,0,0,179
1,VIC,213,Boolarra,190,37.55,316,62.45,506,98.64,7,1.36,513
1,VIC,224,Boort,110,19.23,462,80.77,572,98.96,6,1.04,578
1,VIC,197,Boronia,584,46.42,674,53.58,1258,98.74,16,1.26,1274
1,VIC,197,Boronia ASTON PPVC,6683,39.55,10213,60.45,16896,99,171,1,17067
1,VIC,204,Boronia CASEY PPVC,1846,48.04,1997,51.96,3843,98.92,42,1.08,3885
1,VIC,209,Boronia DEAKIN PPVC,971,37.77,1600,62.23,2571,99.15,22,0.85,2593
1,VIC,197,Boronia East,554,51.2,528,48.8,1082,98.9,12,1.1,1094
1,VIC,197,Boronia North,626,48.6,662,51.4,1288,98.47,20,1.53,1308
1,VIC,197,Boronia West,852,51.64,798,48.36,1650,98.92,18,1.08,1668
1,VIC,216,Botanic Ridge,765,38.52,1221,61.48,1986,99,20,1,2006
1,VIC,205,Box Hill (Chisholm),362,60.94,232,39.06,594,99.17,5,0.83,599
1,VIC,229,Box Hill (Menzies),389,54.25,328,45.75,717,99.17,6,0.83,723
1,VIC,205,Box Hill Central,463,62.74,275,37.26,738,98.66,10,1.34,748
1,VIC,205,Box Hill CHISHOLM PPVC,3494,53.44,3044,46.56,6538,99.14,57,0.86,6595
1,VIC,209,Box Hill DEAKIN PPVC,1563,50.16,1553,49.84,3116,99.17,26,0.83,3142
1,VIC,221,Box Hill KOOYONG PPVC,2945,50.3,2910,49.7,5855,99.24,45,0.76,5900
1,VIC,229,Box Hill MENZIES PPVC,3450,49.9,3464,50.1,6914,99.14,60,0.86,6974
1,VIC,229,Box Hill North,496,61.92,305,38.08,801,99.13,7,0.87,808
1,VIC,205,Box Hill South,676,66.21,345,33.79,1021,99.61,4,0.39,1025
1,VIC,233,Branxholme,24,17.78,111,82.22,135,97.83,3,2.17,138
1,VIC,321,Braybrook,653,64.78,355,35.22,1008,97.77,23,2.23,1031
1,VIC,213,Briagolong,189,38.81,298,61.19,487,99.59,2,0.41,489
1,VIC,220,Briar Hill,806,61.48,505,38.52,1311,99.24,10,0.76,1321
1,VIC,224,Bridgewater,54,20.53,209,79.47,263,100,0,0,263
1,VIC,322,Bridport,568,73.58,204,26.42,772,99.36,5,0.64,777
1,VIC,218,Bright,247,56.39,191,43.61,438,98.65,6,1.35,444
1,VIC,218,Bright PPVC,1153,43.64,1489,56.36,2642,99.29,19,0.71,2661
1,VIC,214,Brighton,1167,54.94,957,45.06,2124,99.25,16,0.75,2140
1,VIC,214,Brighton Beach,714,57.17,535,42.83,1249,99.13,11,0.87,1260
1,VIC,214,Brighton East,653,50.86,631,49.14,1284,99.38,8,0.62,1292
1,VIC,214,Brighton East Upper,927,63.49,533,36.51,1460,98.92,16,1.08,1476
1,VIC,214,Brighton GOLDSTEIN PPVC,7508,50.9,7242,49.1,14750,99.35,97,0.65,14847
1,VIC,322,Brighton MACNAMARA PPVC,4320,65.66,2259,34.34,6579,99.29,47,0.71,6626
1,VIC,214,Brighton North,1154,58.58,816,41.42,1970,98.75,25,1.25,1995
1,VIC,324,Broadford,501,31.71,1079,68.29,1580,98.75,20,1.25,1600
1,VIC,203,Broadmeadows,570,52.49,516,47.51,1086,96.62,38,3.38,1124
1,VIC,203,Broadmeadows North,634,48.47,674,51.53,1308,98.12,25,1.88,1333
1,VIC,326,Brookfield,760,48.53,806,51.47,1566,99.24,12,0.76,1578
1,VIC,198,Brown Hill,672,47.09,755,52.91,1427,99.3,10,0.7,1437
1,VIC,234,Brunswick,1975,86.74,302,13.26,2277,99.04,22,0.96,2299
1,VIC,228,Brunswick East (Melbourne),630,83,129,17,759,99.09,7,0.91,766
1,VIC,234,Brunswick East (Wills),809,82.97,166,17.03,975,99.29,7,0.71,982
1,VIC,234,Brunswick North,1951,83.84,376,16.16,2327,98.77,29,1.23,2356
1,VIC,234,Brunswick North East,1750,89.38,208,10.62,1958,98.84,23,1.16,1981
1,VIC,234,Brunswick North West,790,80.86,187,19.14,977,97.6,24,2.4,1001
1,VIC,234,Brunswick South,919,86.86,139,13.14,1058,99.06,10,0.94,1068
1,VIC,228,Brunswick South East (Melbourne),1020,88.93,127,11.07,1147,99.65,4,0.35,1151
1,VIC,234,Brunswick South East (Wills),636,92.17,54,7.83,690,99.28,5,0.72,695
1,VIC,234,Brunswick South West,1371,89.43,162,10.57,1533,99.03,15,0.97,1548
1,VIC,234,Brunswick West,859,74.7,291,25.3,1150,99.05,11,0.95,1161
1,VIC,213,Bruthen,134,31.09,297,68.91,431,99.08,4,0.92,435
1,VIC,213,Buchan,59,39.6,90,60.4,149,99.33,1,0.67,150
1,VIC,229,Bulleen,633,39.24,980,60.76,1613,98.65,22,1.35,1635
1,VIC,229,Bulleen Lower,476,46.62,545,53.38,1021,98.74,13,1.26,1034
1,VIC,226,Bullengarook,171,52.62,154,47.38,325,99.09,3,0.91,328
1,VIC,323,Buln Buln,123,33.24,247,66.76,370,99.46,2,0.54,372
1,VIC,324,Bunbartha,48,22.02,170,77.98,218,98.64,3,1.36,221
1,VIC,213,Bundalaguah,35,26.72,96,73.28,131,99.24,1,0.76,132
1,VIC,320,Bundoora (Cooper),196,54.14,166,45.86,362,98.91,4,1.09,366
1,VIC,220,Bundoora (Jagajaga),426,48.3,456,51.7,882,98.11,17,1.89,899
1,VIC,220,Bundoora Central,296,43.92,378,56.08,674,98.97,7,1.03,681
1,VIC,320,Bundoora South,534,58.36,381,41.64,915,98.71,12,1.29,927
1,VIC,232,Bundoora West,685,44.71,847,55.29,1532,98.52,23,1.48,1555
1,VIC,198,Bungaree,111,26.75,304,73.25,415,98.81,5,1.19,420
1,VIC,198,Buninyong,1013,53.65,875,46.35,1888,99.32,13,0.68,1901
1,VIC,223,Bunyip,385,30.13,893,69.87,1278,98.84,15,1.16,1293
1,VIC,228,Burnley,1121,76.73,340,23.27,1461,99.32,10,0.68,1471
1,VIC,309,Burnside,470,48.96,490,51.04,960,98.97,10,1.03,970
1,VIC,309,Burnside Heights,700,44.16,885,55.84,1585,99,16,1,1601
1,VIC,205,Burwood Central,613,59.86,411,40.14,1024,99.22,8,0.78,1032
1,VIC,205,Burwood East,449,47.51,496,52.49,945,99.06,9,0.94,954
1,VIC,205,Burwood East Lower,260,53.17,229,46.83,489,98.59,7,1.41,496
1,VIC,205,Burwood East Upper,674,53.11,595,46.89,1269,99.14,11,0.86,1280
1,VIC,205,Burwood Heights (Chisholm),310,47.33,345,52.67,655,98.94,7,1.06,662
1,VIC,209,Burwood Heights (Deakin),670,48.87,701,51.13,1371,98.92,15,1.08,1386
1,VIC,324,Byrneside,50,17.67,233,82.33,283,98.95,3,1.05,286
1,VIC,224,Cabarita,101,22.85,341,77.15,442,99.33,3,0.67,445
1,VIC,321,Cairnlea (Fraser),991,50.48,972,49.52,1963,99.39,12,0.61,1975
1,VIC,309,Cairnlea (Gorton),119,47.79,130,52.21,249,98.42,4,1.58,253
1,VIC,200,California Gully,73,33.8,143,66.2,216,100,0,0,216
1,VIC,224,Calivil,19,13.97,117,86.03,136,100,0,0,136
1,VIC,221,Camberwell,775,67.51,373,32.49,1148,99.22,9,0.78,1157
1,VIC,215,Camberwell HIGGINS PPVC,753,57.52,556,42.48,1309,99.09,12,0.91,1321
1,VIC,221,Camberwell KOOYONG PPVC,9728,56.03,7634,43.97,17362,99.46,94,0.54,17456
1,VIC,228,Camberwell MELBOURNE PPVC,511,65.85,265,34.15,776,99.74,2,0.26,778
1,VIC,221,Camberwell Middle,756,60.82,487,39.18,1243,99.6,5,0.4,1248
1,VIC,215,Camberwell South (Higgins),566,66.43,286,33.57,852,99.65,3,0.35,855
1,VIC,221,Camberwell South (Kooyong),285,61.96,175,38.04,460,99.14,4,0.86,464
1,VIC,221,Camberwell West,1011,64.64,553,35.36,1564,99.3,11,0.7,1575
1,VIC,222,Cambridge,732,48.38,781,51.62,1513,98.63,21,1.37,1534
1,VIC,203,Campbellfield,410,34.86,766,65.14,1176,96.71,40,3.29,1216
1,VIC,200,Campbells Creek,397,55.92,313,44.08,710,98.34,12,1.66,722
1,VIC,233,Camperdown,540,28.35,1365,71.65,1905,98.7,25,1.3,1930
1,VIC,198,Canadian,635,50.36,626,49.64,1261,98.52,19,1.48,1280
1,VIC,221,Canterbury,317,52.57,286,47.43,603,98.85,7,1.15,610
1,VIC,221,Canterbury South,983,64.97,530,35.03,1513,99.21,12,0.79,1525
1,VIC,221,Canterbury West,257,50.99,247,49.01,504,99.21,4,0.79,508
1,VIC,198,Cape Clear,64,27.83,166,72.17,230,100,0,0,230
1,VIC,323,Cape Paterson,178,58.36,127,41.64,305,97.44,8,2.56,313
1,VIC,198,Cardigan Village,117,34.93,218,65.07,335,99.11,3,0.89,338
1,VIC,224,Cardross,88,20.18,348,79.82,436,99.54,2,0.46,438
1,VIC,224,Carisbrook,90,32.26,189,67.74,279,99.64,1,0.36,280
1,VIC,228,Carlton,873,80.61,210,19.39,1083,98.63,15,1.37,1098
1,VIC,228,Carlton Central,1672,90.33,179,9.67,1851,99.52,9,0.48,1860
1,VIC,228,Carlton South,1340,78.96,357,21.04,1697,99.18,14,0.82,1711
1,VIC,215,Carnegie,1477,67.69,705,32.31,2182,98.91,24,1.09,2206
1,VIC,215,Carnegie East,888,60.95,569,39.05,1457,98.85,17,1.15,1474
1,VIC,215,Carnegie North,957,64.97,516,35.03,1473,99.8,3,0.2,1476
1,VIC,215,Carnegie Upper,618,68.44,285,31.56,903,98.69,12,1.31,915
1,VIC,214,Carnegie West (Goldstein),550,68.32,255,31.68,805,99.38,5,0.62,810
1,VIC,215,Carnegie West (Higgins),624,69.57,273,30.43,897,98.68,12,1.32,909
1,VIC,309,Caroline Springs,552,49.02,574,50.98,1126,98.25,20,1.75,1146
1,VIC,309,Caroline Springs Central,968,46.79,1101,53.21,2069,98.76,26,1.24,2095
1,VIC,321,Caroline Springs FRASER PPVC,311,39.52,476,60.48,787,98.99,8,1.01,795
1,VIC,309,Caroline Springs GORTON PPVC,7688,34.72,14453,65.28,22141,98.82,265,1.18,22406
1,VIC,326,Caroline Springs HAWKE PPVC,523,26.81,1428,73.19,1951,98.83,23,1.17,1974
1,VIC,309,Caroline Springs North,660,41.85,917,58.15,1577,99.12,14,0.88,1591
1,VIC,309,Caroline Springs South,1064,42.99,1411,57.01,2475,98.64,34,1.36,2509
1,VIC,233,Carpendeit,43,18.86,185,81.14,228,99.56,1,0.44,229
1,VIC,219,Carrum,677,56.8,515,43.2,1192,98.68,16,1.32,1208
1,VIC,210,Carrum Downs,598,42.5,809,57.5,1407,98.19,26,1.81,1433
1,VIC,210,Carrum Downs Central,870,41.25,1239,58.75,2109,98.78,26,1.22,2135
1,VIC,210,Carrum Downs DUNKLEY PPVC,5260,35.02,9761,64.98,15021,99.06,142,0.94,15163
1,VIC,216,Carrum Downs HOLT PPVC,448,32.89,914,67.11,1362,99.13,12,0.87,1374
1,VIC,219,Carrum Downs ISAACS PPVC,731,35.54,1326,64.46,2057,99.23,16,0.77,2073
1,VIC,210,Carrum Downs North,871,44.21,1099,55.79,1970,98.6,28,1.4,1998
1,VIC,210,Carrum Downs South,437,41.9,606,58.1,1043,97.84,23,2.16,1066
1,VIC,210,Carrum Downs West,140,47.46,155,52.54,295,99.66,1,0.34,296
1,VIC,216,Casey Fields,996,52.39,905,47.61,1901,99.11,17,0.89,1918
1,VIC,233,Casterton,239,22.27,834,77.73,1073,98.71,14,1.29,1087
1,VIC,200,Castlemaine,795,69.86,343,30.14,1138,99.22,9,0.78,1147
1,VIC,200,Castlemaine North,315,77.59,91,22.41,406,99.51,2,0.49,408
1,VIC,200,Castlemaine PPVC,3638,56.91,2754,43.09,6392,99.1,58,0.9,6450
1,VIC,200,Castlemaine South,400,74.77,135,25.23,535,98.89,6,1.11,541
1,VIC,322,Caulfield,389,53.14,343,46.86,732,99.59,3,0.41,735
1,VIC,322,Caulfield East,515,61.75,319,38.25,834,98.93,9,1.07,843
1,VIC,322,Caulfield North,583,58.42,415,41.58,998,98.71,13,1.29,1011
1,VIC,214,Caulfield South,557,60.74,360,39.26,917,99.57,4,0.43,921
1,VIC,214,Caulfield South Central (Goldstein),375,67.45,181,32.55,556,99.11,5,0.89,561
1,VIC,322,Caulfield South Central (Macnamara),336,65.75,175,34.25,511,98.46,8,1.54,519
1,VIC,214,Caulfield South East,931,58.63,657,41.37,1588,98.82,19,1.18,1607
1,VIC,214,Caulfield South West,727,62.73,432,37.27,1159,99.06,11,0.94,1170
1,VIC,322,Caulfield Upper,1126,68.57,516,31.43,1642,99.21,13,0.79,1655
1,VIC,233,Cavendish,42,21.65,152,78.35,194,99.49,1,0.51,195
1,VIC,328,Ceres,237,47.49,262,52.51,499,99.8,1,0.2,500
1,VIC,215,Chadstone,712,56.42,550,43.58,1262,98.83,15,1.17,1277
1,VIC,205,Chadstone East,715,55.47,574,44.53,1289,98.77,16,1.23,1305
1,VIC,328,Charlemont,661,59.76,445,40.24,1106,98.75,14,1.25,1120
1,VIC,224,Charlton,128,20.51,496,79.49,624,99.21,5,0.79,629
1,VIC,221,Chatham,1043,70.38,439,29.62,1482,99.4,9,0.6,1491
1,VIC,219,Chelsea,411,58.8,288,41.2,699,98.31,12,1.69,711
1,VIC,219,Chelsea Central,1148,57.26,857,42.74,2005,98.91,22,1.09,2027
1,VIC,219,Chelsea Heights,1211,53.89,1036,46.11,2247,98.86,26,1.14,2273
1,VIC,214,Cheltenham (Goldstein),547,63.24,318,36.76,865,98.63,12,1.37,877
1,VIC,219,Cheltenham (Isaacs),815,65.78,424,34.22,1239,98.73,16,1.27,1255
1,VIC,219,Cheltenham East,765,57.22,572,42.78,1337,98.89,15,1.11,1352
1,VIC,219,Cheltenham North,618,54.4,518,45.6,1136,98.02,23,1.98,1159
1,VIC,219,Cheltenham South,513,57.71,376,42.29,889,98.56,13,1.44,902
1,VIC,200,Chewton,253,71.27,102,28.73,355,99.44,2,0.56,357
1,VIC,218,Chiltern,210,30.57,477,69.43,687,99.42,4,0.58,691
1,VIC,204,Chirnside Park,843,39.9,1270,60.1,2113,98.92,23,1.08,2136
1,VIC,204,Chirnside Park PPVC,2145,36.56,3722,63.44,5867,98.94,63,1.06,5930
1,VIC,213,Churchill,254,34,493,66,747,99.07,7,0.93,754
1,VIC,213,Churchill Central,152,42.94,202,57.06,354,99.44,2,0.56,356
1,VIC,217,Clarinda,677,43.43,882,56.57,1559,99.43,9,0.57,1568
1,VIC,217,Clarinda North,705,50.9,680,49.1,1385,98.79,17,1.21,1402
1,VIC,217,Clarinda South,441,46.72,503,53.28,944,98.54,14,1.46,958
1,VIC,217,Clayton,558,60,372,40,930,98.94,10,1.06,940
1,VIC,205,Clayton North (Chisholm),253,72.08,98,27.92,351,99.15,3,0.85,354
1,VIC,217,Clayton North (Hotham),445,56.05,349,43.95,794,99.37,5,0.63,799
1,VIC,217,Clayton South,539,47.07,606,52.93,1145,99.13,10,0.87,1155
1,VIC,217,Clayton South East,975,54.96,799,45.04,1774,98.78,22,1.22,1796
1,VIC,228,Clifton Hill,995,87.9,137,12.1,1132,99.39,7,0.61,1139
1,VIC,328,Clifton Springs,823,45.62,981,54.38,1804,98.96,19,1.04,1823
1,VIC,328,Clifton Springs PPVC,3212,37.59,5332,62.41,8544,99.21,68,0.79,8612
1,VIC,226,Clonbinane,55,33.95,107,66.05,162,97.59,4,2.41,166
1,VIC,198,Clunes,347,43.38,453,56.63,800,98.04,16,1.96,816
1,VIC,216,Clyde (Holt),1157,50.39,1139,49.61,2296,98.88,26,1.12,2322
1,VIC,223,Clyde (La Trobe),237,57.66,174,42.34,411,99.28,3,0.72,414
1,VIC,216,Clyde North (Holt),834,51.96,771,48.04,1605,99.5,8,0.5,1613
1,VIC,223,Clyde North (La Trobe),199,54.97,163,45.03,362,99.18,3,0.82,365
1,VIC,223,Clyde North Central,1227,58.91,856,41.09,2083,99.43,12,0.57,2095
1,VIC,223,Clyde North East,1136,55.77,901,44.23,2037,99.27,15,0.73,2052
1,VIC,217,Coatesville,1356,53.09,1198,46.91,2554,99.03,25,0.97,2579
1,VIC,217,Coatesville North,528,48.26,566,51.74,1094,98.83,13,1.17,1107
1,VIC,213,Cobains,27,23.68,87,76.32,114,97.44,3,2.56,117
1,VIC,233,Cobden,254,23.87,810,76.13,1064,98.25,19,1.75,1083
1,VIC,324,Cobram,222,24.48,685,75.52,907,98.37,15,1.63,922
1,VIC,324,Cobram NICHOLLS PPVC,611,16.93,2997,83.07,3608,99.42,21,0.58,3629
1,VIC,234,Coburg,1350,76.66,411,23.34,1761,98.66,24,1.34,1785
1,VIC,234,Coburg East,618,69.36,273,30.64,891,98.56,13,1.44,904
1,VIC,320,Coburg Lake (Cooper),103,68.67,47,31.33,150,98.68,2,1.32,152
1,VIC,234,Coburg Lake (Wills),614,72.49,233,27.51,847,99.06,8,0.94,855
1,VIC,234,Coburg North,573,63.25,333,36.75,906,98.37,15,1.63,921
1,VIC,234,Coburg North West,1094,67.7,522,32.3,1616,98.66,22,1.34,1638
1,VIC,234,Coburg South,478,61.76,296,38.24,774,97.85,17,2.15,791
1,VIC,234,Coburg West,1546,70.59,644,29.41,2190,97.64,53,2.36,2243
1,VIC,326,Coburn,479,38.75,757,61.25,1236,98.64,17,1.36,1253
1,VIC,223,Cockatoo,706,43.47,918,56.53,1624,98.84,19,1.16,1643
1,VIC,224,Cohuna,211,15.31,1167,84.69,1378,99.07,13,0.93,1391
1,VIC,233,Colac East,353,32.18,744,67.82,1097,98.83,13,1.17,1110
1,VIC,233,Colac PPVC,2104,26.59,5808,73.41,7912,99.09,73,0.91,7985
1,VIC,233,Colac West,251,35.6,454,64.4,705,98.88,8,1.12,713
1,VIC,324,Colbinabbin,86,32.7,177,67.3,263,98.87,3,1.13,266
1,VIC,204,Coldstream,227,29.4,545,70.6,772,99.36,5,0.64,777
1,VIC,233,Coleraine,116,22.05,410,77.95,526,99.06,5,0.94,531
1,VIC,228,Collingwood,1387,88.23,185,11.77,1572,99.05,15,0.95,1587
1,VIC,228,Collingwood North,1331,85.59,224,14.41,1555,99.68,5,0.32,1560
1,VIC,224,Concongella,30,18.07,136,81.93,166,98.81,2,1.19,168
1,VIC,324,Congupna,140,26.02,398,73.98,538,99.08,5,0.92,543
1,VIC,328,Connewarre,178,50.57,174,49.43,352,99.72,1,0.28,353
1,VIC,203,Coolaroo,452,39.48,693,60.52,1145,97.7,27,2.3,1172
1,VIC,323,Corinella,254,33.12,513,66.88,767,98.21,14,1.79,781
1,VIC,208,Corio,500,37.43,836,62.57,1336,98.74,17,1.26,1353
1,VIC,208,Corio Central,347,38.26,560,61.74,907,98.8,11,1.2,918
1,VIC,208,Corio West,159,47.46,176,52.54,335,98.24,6,1.76,341
1,VIC,233,Cororooke,91,22.92,306,77.08,397,99.5,2,0.5,399
1,VIC,218,Corryong,219,26.51,607,73.49,826,98.45,13,1.55,839
1,VIC,323,Cowes,546,52.5,494,47.5,1040,99.05,10,0.95,1050
1,VIC,323,Cowes PPVC,2529,42.31,3449,57.69,5978,99.22,47,0.78,6025
1,VIC,213,Cowwarr,42,22.83,142,77.17,184,98.4,3,1.6,187
1,VIC,203,Craigieburn,600,44.25,756,55.75,1356,98.26,24,1.74,1380
1,VIC,203,Craigieburn CALWELL PPVC,7134,42.16,9787,57.84,16921,98.92,185,1.08,17106
1,VIC,203,Craigieburn Central,461,35.96,821,64.04,1282,98.69,17,1.31,1299
1,VIC,226,Craigieburn MCEWEN PPVC,276,42.4,375,57.6,651,99.69,2,0.31,653
1,VIC,203,Craigieburn North,997,44.53,1242,55.47,2239,98.55,33,1.45,2272
1,VIC,203,Craigieburn South,607,36.43,1059,63.57,1666,98.23,30,1.77,1696
1,VIC,203,Craigieburn West,789,48.64,833,51.36,1622,98.66,22,1.34,1644
1,VIC,216,Cranbourne,354,44.58,440,55.42,794,99,8,1,802
1,VIC,201,Cranbourne BRUCE PPVC,375,37.28,631,62.72,1006,99.11,9,0.89,1015
1,VIC,216,Cranbourne Central,214,34.91,399,65.09,613,99.03,6,0.97,619
1,VIC,210,Cranbourne DUNKLEY PPVC,104,33.55,206,66.45,310,99.04,3,0.96,313
1,VIC,216,Cranbourne East,1325,49.79,1336,50.21,2661,99.03,26,0.97,2687
1,VIC,216,Cranbourne Heights,774,47.28,863,52.72,1637,98.91,18,1.09,1655
1,VIC,216,Cranbourne HOLT PPVC,7660,38.12,12436,61.88,20096,99.15,172,0.85,20268
1,VIC,223,Cranbourne LA TROBE PPVC,891,43.02,1180,56.98,2071,99.42,12,0.58,2083
1,VIC,201,Cranbourne North (Bruce),122,45.35,147,54.65,269,98.53,4,1.47,273
1,VIC,216,Cranbourne North (Holt),504,51.85,468,48.15,972,99.49,5,0.51,977
1,VIC,216,Cranbourne North Central,942,47.38,1046,52.62,1988,98.17,37,1.83,2025
1,VIC,216,Cranbourne North East,631,55.06,515,44.94,1146,98.88,13,1.12,1159
1,VIC,216,Cranbourne North Upper (Holt),920,54.5,768,45.5,1688,99,17,1,1705
1,VIC,223,Cranbourne North Upper (La Trobe),344,50.15,342,49.85,686,99.42,4,0.58,690
1,VIC,216,Cranbourne North West,470,46.17,548,53.83,1018,98.64,14,1.36,1032
1,VIC,216,Cranbourne Park,550,40.38,812,59.62,1362,98.91,15,1.09,1377
1,VIC,216,Cranbourne South West,974,52.56,879,47.44,1853,99.41,11,0.59,1864
1,VIC,216,Cranbourne West,1220,44.41,1527,55.59,2747,98.32,47,1.68,2794
1,VIC,228,Cremorne,1273,77.25,375,22.75,1648,99.34,11,0.66,1659
1,VIC,233,Cressy,26,22.22,91,77.78,117,99.15,1,0.85,118
1,VIC,198,Creswick,477,45.82,564,54.18,1041,99.05,10,0.95,1051
1,VIC,198,Creswick North,208,39.25,322,60.75,530,99.44,3,0.56,533
1,VIC,211,Crib Point,241,44.06,306,55.94,547,98.74,7,1.26,554
1,VIC,320,Croxton,593,87.98,81,12.02,674,100,0,0,674
1,VIC,209,Croydon,1149,53.12,1014,46.88,2163,98.68,29,1.32,2192
1,VIC,204,Croydon CASEY PPVC,1872,37,3188,63,5060,99.18,42,0.82,5102
1,VIC,209,Croydon Central,526,53.67,454,46.33,980,98.49,15,1.51,995
1,VIC,209,Croydon DEAKIN PPVC,4535,40.75,6595,59.25,11130,99.14,97,0.86,11227
1,VIC,209,Croydon East,756,51.15,722,48.85,1478,98.93,16,1.07,1494
1,VIC,209,Croydon Hills,873,49.38,895,50.62,1768,98.44,28,1.56,1796
1,VIC,209,Croydon North,434,54.11,368,45.89,802,99.01,8,0.99,810
1,VIC,209,Croydon North Upper,509,44.69,630,55.31,1139,98.96,12,1.04,1151
1,VIC,209,Croydon South,419,49.01,436,50.99,855,99.19,7,0.81,862
1,VIC,209,Croydon Town,207,63.11,121,36.89,328,100,0,0,328
1,VIC,209,Croydon West,504,56.5,388,43.5,892,99.55,4,0.45,896
1,VIC,218,Cudgewa,35,20.83,133,79.17,168,99.41,1,0.59,169
1,VIC,203,Dallas,426,44.38,534,55.63,960,95.62,44,4.38,1004
1,VIC,323,Dalyston,175,48.61,185,51.39,360,98.9,4,1.1,364
1,VIC,201,Dandenong,543,54.68,450,45.32,993,98.32,17,1.68,1010
1,VIC,201,Dandenong BRUCE PPVC,6827,41.48,9630,58.52,16457,98.91,182,1.09,16639
1,VIC,201,Dandenong Central,650,60.47,425,39.53,1075,98.44,17,1.56,1092
1,VIC,216,Dandenong HOLT PPVC,457,45.7,543,54.3,1000,98.23,18,1.77,1018
1,VIC,217,Dandenong HOTHAM PPVC,599,46.98,676,53.02,1275,98.23,23,1.77,1298
1,VIC,219,Dandenong ISAACS PPVC,613,41.09,879,58.91,1492,98.68,20,1.32,1512
1,VIC,201,Dandenong North,526,37.36,882,62.64,1408,98.46,22,1.54,1430
1,VIC,201,Dandenong North East,501,49.31,515,50.69,1016,98.45,16,1.55,1032
1,VIC,201,Dandenong North Lower,573,51.3,544,48.7,1117,97.98,23,2.02,1140
1,VIC,201,Dandenong North West,674,46.26,783,53.74,1457,98.58,21,1.42,1478
1,VIC,219,Dandenong South,554,43.49,720,56.51,1274,97.4,34,2.6,1308
1,VIC,201,Dandenong Upper,589,52.87,525,47.13,1114,98.24,20,1.76,1134
1,VIC,201,Dandenong West,529,53.38,462,46.62,991,98.41,16,1.59,1007
1,VIC,320,Darebin,306,43.84,392,56.16,698,97.9,15,2.1,713
1,VIC,326,Darley,566,36.73,975,63.27,1541,98.59,22,1.41,1563
1,VIC,215,Darling,597,63.04,350,36.96,947,99.58,4,0.42,951
1,VIC,323,Darnum,82,20.97,309,79.03,391,99.74,1,0.26,392
1,VIC,226,Darraweit Guim,86,32.95,175,67.05,261,99.24,2,0.76,263
1,VIC,233,Dartmoor,35,15.22,195,84.78,230,100,0,0,230
1,VIC,222,Davis Creek,1485,67.68,709,32.32,2194,98.83,26,1.17,2220
1,VIC,198,Daylesford,854,61.71,530,38.29,1384,99.07,13,0.93,1397
1,VIC,233,Deans Marsh,164,64.06,92,35.94,256,99.22,2,0.78,258
1,VIC,218,Dederang,72,25,216,75,288,99.31,2,0.69,290
1,VIC,221,Deepdene,835,57.83,609,42.17,1444,99.24,11,0.76,1455
1,VIC,309,Deer Park,449,43.34,587,56.66,1036,97.74,24,2.26,1060
1,VIC,309,Deer Park Central,304,47.28,339,52.72,643,98.32,11,1.68,654
1,VIC,309,Deer Park West,663,47.32,738,52.68,1401,99.08,13,0.92,1414
1,VIC,198,Delacombe,474,42.51,641,57.49,1115,98.41,18,1.59,1133
1,VIC,309,Delahey,728,41.27,1036,58.73,1764,98.33,30,1.67,1794
1,VIC,228,Delbridge,1015,86.98,152,13.02,1167,99.49,6,0.51,1173
1,VIC,233,Dennington,171,36.46,298,63.54,469,98.32,8,1.68,477
1,VIC,198,Dereel,109,35.28,200,64.72,309,99.68,1,0.32,310
1,VIC,309,Derrimut,1023,51.64,958,48.36,1981,98.31,34,1.69,2015
1,VIC,222,Derrimut Heath,433,38.49,692,61.51,1125,98.77,14,1.23,1139
1,VIC,233,Derrinallum,60,22.73,204,77.27,264,98.88,3,1.12,267
1,VIC,216,Devon Meadows,239,27.63,626,72.37,865,98.3,15,1.7,880
1,VIC,213,Devon North,72,23.45,235,76.55,307,100,0,0,307
1,VIC,324,Dhurringile,33,22.3,115,77.7,148,98.67,2,1.33,150
1,VIC,226,Diamond Creek,1311,54,1117,46,2428,98.86,28,1.14,2456
1,VIC,226,Diamond Creek East,519,48.92,542,51.08,1061,98.61,15,1.39,1076
1,VIC,326,Diggers Rest,574,40.17,855,59.83,1429,98.82,17,1.18,1446
1,VIC,224,Dimboola,205,26.21,577,73.79,782,99.24,6,0.76,788
1,VIC,224,Dingee,20,12.27,143,87.73,163,99.39,1,0.61,164
1,VIC,219,Dingley,198,47.14,222,52.86,420,98.82,5,1.18,425
1,VIC,219,Dingley South,304,47.43,337,52.57,641,98.92,7,1.08,648
1,VIC,219,Dingley Village,974,44.56,1212,55.44,2186,98.78,27,1.22,2213
1,VIC,228,Docklands,1261,62,773,38,2034,98.98,21,1.02,2055
1,VIC,224,Donald,161,18.74,698,81.26,859,99.31,6,0.69,865
1,VIC,229,Doncaster,178,45.41,214,54.59,392,98.74,5,1.26,397
1,VIC,229,Doncaster Central,910,47.57,1003,52.43,1913,98.91,21,1.09,1934
1,VIC,229,Doncaster East,741,43.28,971,56.72,1712,98.5,26,1.5,1738
1,VIC,229,Doncaster East Central,328,51.41,310,48.59,638,99.07,6,0.93,644
1,VIC,220,Doncaster East JAGAJAGA PPVC,346,50.29,342,49.71,688,98.85,8,1.15,696
1,VIC,229,Doncaster East Lower,410,48.18,441,51.82,851,98.84,10,1.16,861
1,VIC,229,Doncaster East MENZIES PPVC,6864,36.85,11765,63.15,18629,99.06,177,0.94,18806
1,VIC,229,Doncaster East Upper,273,38.29,440,61.71,713,98.62,10,1.38,723
1,VIC,229,Doncaster Gardens,247,38.47,395,61.53,642,98.62,9,1.38,651
1,VIC,229,Doncaster Heights,401,44.07,509,55.93,910,98.7,12,1.3,922
1,VIC,229,Doncaster North,626,48.68,660,51.32,1286,98.17,24,1.83,1310
1,VIC,229,Doncaster South,444,52.92,395,47.08,839,99.41,5,0.59,844
1,VIC,229,Doncaster West,296,49.33,304,50.67,600,99.17,5,0.83,605
1,VIC,229,Donvale,232,50.99,223,49.01,455,99.13,4,0.87,459
1,VIC,229,Donvale South,454,42.87,605,57.13,1059,98.06,21,1.94,1080
1,VIC,229,Donvale Upper,636,48.4,678,51.6,1314,99.17,11,0.83,1325
1,VIC,324,Dookie,59,25,177,75,236,99.58,1,0.42,237
1,VIC,226,Doreen,336,39.12,523,60.88,859,99.19,7,0.81,866
1,VIC,226,Doreen Central,690,43.31,903,56.69,1593,99.19,13,0.81,1606
1,VIC,226,Doreen East,697,46.65,797,53.35,1494,99.07,14,0.93,1508
1,VIC,201,Doveton,672,53.16,592,46.84,1264,98.06,25,1.94,1289
1,VIC,201,Doveton West,505,48.98,526,51.02,1031,98.66,14,1.34,1045
1,VIC,211,Dromana,579,48.01,627,51.99,1206,98.21,22,1.79,1228
1,VIC,211,Dromana Beach,255,48.76,268,51.24,523,98.68,7,1.32,530
1,VIC,211,Dromana North,516,47.17,578,52.83,1094,98.83,13,1.17,1107
1,VIC,323,Drouin,688,31.73,1480,68.27,2168,98.91,24,1.09,2192
1,VIC,323,Drouin Central,169,39.12,263,60.88,432,98.41,7,1.59,439
1,VIC,323,Drouin South,84,23.66,271,76.34,355,98.34,6,1.66,361
1,VIC,323,Drouin Summerhill,359,31.41,784,68.59,1143,98.79,14,1.21,1157
1,VIC,323,Drouin West,135,30.75,304,69.25,439,99.55,2,0.45,441
1,VIC,198,Drummond,130,62.8,77,37.2,207,99.04,2,0.96,209
1,VIC,328,Drysdale,536,45.97,630,54.03,1166,98.98,12,1.02,1178
1,VIC,322,Duggan,885,79.3,231,20.7,1116,99.11,10,0.89,1126
1,VIC,323,Dumbalk,109,26.72,299,73.28,408,99.76,1,0.24,409
1,VIC,233,Dunkeld,132,37.93,216,62.07,348,99.15,3,0.85,351
1,VIC,224,Dunolly,130,26.58,359,73.42,489,99.59,2,0.41,491
1,VIC,213,Eagle Point,130,37.14,220,62.86,350,99.15,3,0.85,353
1,VIC,200,Eaglehawk,481,35.47,875,64.53,1356,98.62,19,1.38,1375
1,VIC,200,Eaglehawk East,248,38.27,400,61.73,648,97.59,16,2.41,664
1,VIC,200,Eaglehawk PPVC,3768,27.3,10036,72.7,13804,99.14,120,0.86,13924
1,VIC,228,East Melbourne,1487,73.04,549,26.96,2036,99.17,17,0.83,2053
1,VIC,213,Eastwood,264,31.69,569,68.31,833,98.58,12,1.42,845
1,VIC,197,EAV Aston PPVC,0,0,0,0,0,0,0,0,0
1,VIC,198,EAV Ballarat PPVC,8,61.54,5,38.46,13,100,0,0,13
1,VIC,200,EAV Bendigo PPVC,2,28.57,5,71.43,7,100,0,0,7
1,VIC,201,EAV Bruce PPVC,0,0,0,0,0,0,0,0,0
1,VIC,203,EAV Calwell PPVC,0,0,0,0,0,0,0,0,0
1,VIC,204,EAV Casey PPVC,12,66.67,6,33.33,18,100,0,0,18
1,VIC,205,EAV Chisholm PPVC,0,0,0,0,0,0,0,0,0
1,VIC,320,EAV Cooper PPVC,12,60,8,40,20,100,0,0,20
1,VIC,328,EAV Corangamite PPVC,7,70,3,30,10,100,0,0,10
1,VIC,208,EAV Corio PPVC,12,60,8,40,20,100,0,0,20
1,VIC,209,EAV Deakin PPVC,0,0,0,0,0,0,0,0,0
1,VIC,210,EAV Dunkley PPVC,6,40,9,60,15,100,0,0,15
1,VIC,211,EAV Flinders PPVC,8,57.14,6,42.86,14,100,0,0,14
1,VIC,321,EAV Fraser PPVC,0,0,0,0,0,0,0,0,0
1,VIC,212,EAV Gellibrand PPVC,0,0,0,0,0,0,0,0,0
1,VIC,213,EAV Gippsland PPVC,0,0,0,0,0,0,0,0,0
1,VIC,214,EAV Goldstein PPVC,12,63.16,7,36.84,19,100,0,0,19
1,VIC,309,EAV Gorton PPVC,0,0,0,0,0,0,0,0,0
1,VIC,326,EAV Hawke PPVC,9,60,6,40,15,100,0,0,15
1,VIC,215,EAV Higgins PPVC,19,70.37,8,29.63,27,100,0,0,27
1,VIC,216,EAV Holt PPVC,5,50,5,50,10,100,0,0,10
1,VIC,217,EAV Hotham PPVC,7,38.89,11,61.11,18,100,0,0,18
1,VIC,218,EAV Indi PPVC,0,0,0,0,0,0,0,0,0
1,VIC,219,EAV Isaacs PPVC,16,57.14,12,42.86,28,100,0,0,28
1,VIC,220,EAV Jagajaga PPVC,8,40,12,60,20,100,0,0,20
1,VIC,221,EAV Kooyong PPVC,13,59.09,9,40.91,22,100,0,0,22
1,VIC,223,EAV La Trobe PPVC,0,0,0,0,0,0,0,0,0
1,VIC,222,EAV Lalor PPVC,0,0,0,0,0,0,0,0,0
1,VIC,322,EAV Macnamara PPVC,14,58.33,10,41.67,24,96,1,4,25
1,VIC,224,EAV Mallee PPVC,4,33.33,8,66.67,12,100,0,0,12
1,VIC,225,EAV Maribyrnong PPVC,16,55.17,13,44.83,29,100,0,0,29
1,VIC,226,EAV McEwen PPVC,2,25,6,75,8,100,0,0,8
1,VIC,228,EAV Melbourne PPVC,24,80,6,20,30,100,0,0,30
1,VIC,229,EAV Menzies PPVC,19,65.52,10,34.48,29,100,0,0,29
1,VIC,323,EAV Monash PPVC,4,33.33,8,66.67,12,92.31,1,7.69,13
1,VIC,324,EAV Nicholls PPVC,0,0,0,0,0,0,0,0,0
1,VIC,232,EAV Scullin PPVC,0,0,0,0,0,0,0,0,0
1,VIC,233,EAV Wannon PPVC,3,21.43,11,78.57,14,100,0,0,14
1,VIC,234,EAV Wills PPVC,28,75.68,9,24.32,37,100,0,0,37
1,VIC,324,Echuca,339,29.17,823,70.83,1162,99.06,11,0.94,1173
1,VIC,324,Echuca East,167,23.55,542,76.45,709,99.02,7,0.98,716
1,VIC,324,Echuca NICHOLLS PPVC,2052,19.02,8737,80.98,10789,99.28,78,0.72,10867
1,VIC,324,Echuca West,113,29.89,265,70.11,378,98.44,6,1.56,384
1,VIC,233,Ecklin South,47,22.17,165,77.83,212,99.53,1,0.47,213
1,VIC,224,Edenhope,111,19.41,461,80.59,572,99.48,3,0.52,575
1,VIC,320,Edgar,409,51.9,379,48.1,788,97.65,19,2.35,807
1,VIC,320,Edgar North,553,35.91,987,64.09,1540,97.65,37,2.35,1577
1,VIC,219,Edithvale,1178,58.23,845,41.77,2023,98.35,34,1.65,2057
1,VIC,218,Eildon,124,27.02,335,72.98,459,99.57,2,0.43,461
1,VIC,198,Elaine,96,32.54,199,67.46,295,98.01,6,1.99,301
1,VIC,218,Eldorado,85,42.5,115,57.5,200,97.09,6,2.91,206
1,VIC,213,Ellaswood,73,24.75,222,75.25,295,98.99,3,1.01,298
1,VIC,233,Elliminyt,376,34.88,702,65.12,1078,98.9,12,1.1,1090
1,VIC,323,Ellinbank,126,40.51,185,59.49,311,99.04,3,0.96,314
1,VIC,233,Elmhurst,36,30,84,70,120,100,0,0,120
1,VIC,200,Elmore,118,24.63,361,75.37,479,100,0,0,479
1,VIC,200,Elphinstone,97,41.45,137,58.55,234,98.73,3,1.27,237
1,VIC,214,Elsternwick (Goldstein),626,71.79,246,28.21,872,99.54,4,0.46,876
1,VIC,322,Elsternwick (Macnamara),780,68.97,351,31.03,1131,98.78,14,1.22,1145
1,VIC,214,Elsternwick Park,472,79.19,124,20.81,596,99,6,1,602
1,VIC,220,Eltham,1545,67.26,752,32.74,2297,99.05,22,0.95,2319
1,VIC,220,Eltham East,1625,67.29,790,32.71,2415,99.38,15,0.62,2430
1,VIC,220,Eltham North,727,66.03,374,33.97,1101,98.66,15,1.34,1116
1,VIC,220,Eltham North Upper,704,58.18,506,41.82,1210,99.42,7,0.58,1217
1,VIC,322,Elwood,955,74.2,332,25.8,1287,99.08,12,0.92,1299
1,VIC,322,Elwood Central,672,79.81,170,20.19,842,99.18,7,0.82,849
1,VIC,322,Elwood North,1298,80.77,309,19.23,1607,99.38,10,0.62,1617
1,VIC,204,Emerald (Casey),193,50.52,189,49.48,382,99.74,1,0.26,383
1,VIC,223,Emerald (La Trobe),796,49.91,799,50.09,1595,98.88,18,1.12,1613
1,VIC,322,Emerald Hill,1192,68.66,544,31.34,1736,99.48,9,0.52,1745
1,VIC,201,Endeavour Hills,567,44.79,699,55.21,1266,98.83,15,1.17,1281
1,VIC,201,Endeavour Hills Central,267,41.65,374,58.35,641,99.53,3,0.47,644
1,VIC,201,Endeavour Hills East,700,43.18,921,56.82,1621,98.12,31,1.88,1652
1,VIC,201,Endeavour Hills North,407,42.35,554,57.65,961,98.56,14,1.44,975
1,VIC,201,Endeavour Hills North East,593,42.72,795,57.28,1388,99.28,10,0.72,1398
1,VIC,201,Endeavour Hills Upper,743,44.6,923,55.4,1666,99.11,15,0.89,1681
1,VIC,232,Epping,596,43.76,766,56.24,1362,97.77,31,2.23,1393
1,VIC,203,Epping CALWELL PPVC,329,33.81,644,66.19,973,98.88,11,1.12,984
1,VIC,232,Epping Central,512,35.7,922,64.3,1434,98.22,26,1.78,1460
1,VIC,320,Epping COOPER PPVC,307,36.94,524,63.06,831,99.28,6,0.72,837
1,VIC,232,Epping East,307,34.23,590,65.77,897,97.71,21,2.29,918
1,VIC,226,Epping MCEWEN PPVC,978,37.24,1648,62.76,2626,98.83,31,1.17,2657
1,VIC,232,Epping North,675,43.58,874,56.42,1549,98.22,28,1.78,1577
1,VIC,232,Epping SCULLIN PPVC,6289,36.95,10730,63.05,17019,98.71,222,1.29,17241
1,VIC,232,Epping South,544,40.33,805,59.67,1349,98.25,24,1.75,1373
1,VIC,232,Epping Views,839,44.63,1041,55.37,1880,97.76,43,2.24,1923
1,VIC,232,Epping West,638,49,664,51,1302,99.09,12,0.91,1314
1,VIC,200,Epsom,479,35.72,862,64.28,1341,98.03,27,1.97,1368
1,VIC,323,Erica,69,30,161,70,230,99.57,1,0.43,231
1,VIC,218,Eskdale,41,15.95,216,84.05,257,99.61,1,0.39,258
1,VIC,225,Essendon,727,58.68,512,41.32,1239,97.94,26,2.06,1265
1,VIC,203,Essendon CALWELL PPVC,214,30.53,487,69.47,701,99.43,4,0.57,705
1,VIC,225,Essendon East,1101,65.15,589,34.85,1690,99.06,16,0.94,1706
1,VIC,309,Essendon GORTON PPVC,193,30.2,446,69.8,639,99.69,2,0.31,641
1,VIC,225,Essendon Heights,649,49.73,656,50.27,1305,99.39,8,0.61,1313
1,VIC,225,Essendon MARIBYRNONG PPVC,7738,44.96,9473,55.04,17211,98.96,180,1.04,17391
1,VIC,225,Essendon North,825,54.49,689,45.51,1514,98.95,16,1.05,1530
1,VIC,225,Essendon South,794,59.52,540,40.48,1334,98.81,16,1.19,1350
1,VIC,225,Essendon West,663,53.13,585,46.88,1248,98.89,14,1.11,1262
1,VIC,234,Essendon WILLS PPVC,2217,51.32,2103,48.68,4320,98.7,57,1.3,4377
1,VIC,218,Euroa,436,29.52,1041,70.48,1477,98.47,23,1.53,1500
1,VIC,326,Eynesbury,373,37.08,633,62.92,1006,98.82,12,1.18,1018
1,VIC,320,Fairfield,1832,82.37,392,17.63,2224,99.37,14,0.63,2238
1,VIC,320,Fairfield North,678,75.08,225,24.92,903,98.47,14,1.53,917
1,VIC,234,Fawkner,957,49.82,964,50.18,1921,97.61,47,2.39,1968
1,VIC,234,Fawkner East,558,55.86,441,44.14,999,99.01,10,0.99,1009
1,VIC,234,Fawkner North,585,46.76,666,53.24,1251,97.66,30,2.34,1281
1,VIC,215,Fawkner Park (Higgins),156,67.83,74,32.17,230,98.71,3,1.29,233
1,VIC,322,Fawkner Park (Macnamara),764,69.64,333,30.36,1097,99.37,7,0.63,1104
1,VIC,212,Featherbrook,780,59.05,541,40.95,1321,99.25,10,0.75,1331
1,VIC,197,Ferntree Gully,610,51.74,569,48.26,1179,98.83,14,1.17,1193
1,VIC,197,Ferntree Gully Central,905,45.8,1071,54.2,1976,98.55,29,1.45,2005
1,VIC,197,Ferntree Gully Heights,570,45.82,674,54.18,1244,98.5,19,1.5,1263
1,VIC,197,Ferntree Gully North,693,55.62,553,44.38,1246,98.65,17,1.35,1263
1,VIC,197,Ferntree Gully South West,425,42.71,570,57.29,995,99.1,9,0.9,1004
1,VIC,197,Ferntree Gully West,915,47.68,1004,52.32,1919,98.87,22,1.13,1941
1,VIC,204,Ferny Creek,474,66.76,236,33.24,710,98.75,9,1.25,719
1,VIC,323,Fish Creek,297,51.3,282,48.7,579,99.48,3,0.52,582
1,VIC,228,Fitzroy,1437,88.16,193,11.84,1630,99.21,13,0.79,1643
1,VIC,228,Fitzroy Central,1298,83.47,257,16.53,1555,99.17,13,0.83,1568
1,VIC,228,Fitzroy North,1453,88.6,187,11.4,1640,99.45,9,0.55,1649
1,VIC,225,Flemington,1250,80.59,301,19.41,1551,99.04,15,0.96,1566
1,VIC,211,Flinders,236,60.67,153,39.33,389,99.49,2,0.51,391
1,VIC,200,Flora Hill,655,51.17,625,48.83,1280,98.84,15,1.16,1295
1,VIC,218,Flowerdale,135,37.5,225,62.5,360,99.45,2,0.55,362
1,VIC,321,Footscray,939,74.82,316,25.18,1255,98.97,13,1.03,1268
1,VIC,321,Footscray Central,983,85.11,172,14.89,1155,99.74,3,0.26,1158
1,VIC,321,Footscray FRASER PPVC,7589,59.78,5105,40.22,12694,99.02,125,0.98,12819
1,VIC,212,Footscray GELLIBRAND PPVC,394,57.27,294,42.73,688,99.57,3,0.43,691
1,VIC,225,Footscray MARIBYRNONG PPVC,433,56.53,333,43.47,766,99.09,7,0.91,773
1,VIC,228,Footscray MELBOURNE PPVC,104,64.2,58,35.8,162,98.18,3,1.82,165
1,VIC,321,Footscray North,1223,65.86,634,34.14,1857,98.46,29,1.54,1886
1,VIC,321,Footscray South,1138,83.43,226,16.57,1364,99.49,7,0.51,1371
1,VIC,209,Forest Hill,230,53.49,200,46.51,430,98.85,5,1.15,435
1,VIC,209,Forest Hill East,854,56.11,668,43.89,1522,98.96,16,1.04,1538
1,VIC,233,Forrest,123,65.43,65,34.57,188,99.47,1,0.53,189
1,VIC,323,Foster,530,46.9,600,53.1,1130,99.04,11,0.96,1141
1,VIC,201,Fountain Gate,852,47.07,958,52.93,1810,98.91,20,1.09,1830
1,VIC,210,Frankston,969,59.12,670,40.88,1639,98.73,21,1.27,1660
1,VIC,210,Frankston Central,686,56.6,526,43.4,1212,98.3,21,1.7,1233
1,VIC,210,Frankston DUNKLEY PPVC,7531,45.61,8982,54.39,16513,99.05,159,0.95,16672
1,VIC,210,Frankston East,581,45.78,688,54.22,1269,98.99,13,1.01,1282
1,VIC,211,Frankston FLINDERS PPVC,431,45.04,526,54.96,957,98.86,11,1.14,968
1,VIC,210,Frankston Heights,684,53.06,605,46.94,1289,99.38,8,0.62,1297
1,VIC,210,Frankston Heights East,611,46.29,709,53.71,1320,98.8,16,1.2,1336
1,VIC,219,Frankston ISAACS PPVC,454,53.04,402,46.96,856,98.85,10,1.15,866
1,VIC,210,Frankston North,531,41.68,743,58.32,1274,98.3,22,1.7,1296
1,VIC,210,Frankston Rail,499,58.02,361,41.98,860,99.19,7,0.81,867
1,VIC,210,Frankston South,695,53.92,594,46.08,1289,98.85,15,1.15,1304
1,VIC,210,Frankston South East,761,45.06,928,54.94,1689,99.29,12,0.71,1701
1,VIC,210,Frankston South West,771,55.31,623,44.69,1394,99.29,10,0.71,1404
1,VIC,309,Fraser Rise,816,40.08,1220,59.92,2036,98.79,25,1.21,2061
1,VIC,328,Freshwater Creek,111,46.06,130,53.94,241,99.59,1,0.41,242
1,VIC,222,Galvin Park,403,50.88,389,49.12,792,99.25,6,0.75,798
1,VIC,218,Gapsted,82,29.71,194,70.29,276,99.64,1,0.36,277
1,VIC,215,Gardiner,799,67.03,393,32.97,1192,99.17,10,0.83,1202
1,VIC,223,Garfield,239,31.24,526,68.76,765,98.71,10,1.29,775
1,VIC,208,Geelong,1281,61.65,797,38.35,2078,98.62,29,1.38,2107
1,VIC,328,Geelong CORANGAMITE PPVC,497,32.25,1044,67.75,1541,99.23,12,0.77,1553
1,VIC,208,Geelong CORIO PPVC,4009,31.77,8610,68.23,12619,98.86,145,1.14,12764
1,VIC,208,Geelong South,750,61.88,462,38.12,1212,98.46,19,1.54,1231
1,VIC,208,Geelong West,755,66,389,34,1144,98.71,15,1.29,1159
1,VIC,208,Geelong West Upper,602,61.43,378,38.57,980,99.29,7,0.71,987
1,VIC,233,Gellibrand River,102,54.26,86,45.74,188,98.43,3,1.57,191
1,VIC,223,Gembrook,408,42.37,555,57.63,963,99.18,8,0.82,971
1,VIC,324,Girgarre,49,19.22,206,80.78,255,99.61,1,0.39,256
1,VIC,226,Gisborne,1016,47.9,1105,52.1,2121,99.44,12,0.56,2133
1,VIC,226,Gisborne South,608,47.43,674,52.57,1282,98.54,19,1.46,1301
1,VIC,203,Gladstone Park (Calwell),251,35.35,459,64.65,710,98.07,14,1.93,724
1,VIC,225,Gladstone Park (Maribyrnong),539,37.12,913,62.88,1452,98.04,29,1.96,1481
1,VIC,203,Gladstone Park CALWELL PPVC,54,26.21,152,73.79,206,98.1,4,1.9,210
1,VIC,225,Gladstone Park MARIBYRNONG PPVC,3720,36.35,6515,63.65,10235,98.99,104,1.01,10339
1,VIC,225,Gladstone Views,504,36.79,866,63.21,1370,98.7,18,1.3,1388
1,VIC,204,Gladysdale,130,35.14,240,64.86,370,99.73,1,0.27,371
1,VIC,215,Glen Iris,966,65.05,519,34.95,1485,99.26,11,0.74,1496
1,VIC,215,Glen Iris Central,353,68.28,164,31.72,517,98.85,6,1.15,523
1,VIC,221,Glen Iris East,402,64.63,220,35.37,622,98.73,8,1.27,630
1,VIC,209,Glen Park,383,48.12,413,51.88,796,99.13,7,0.87,803
1,VIC,205,Glen Waverley,366,54.71,303,45.29,669,98.82,8,1.18,677
1,VIC,205,Glen Waverley East,414,51.3,393,48.7,807,98.53,12,1.47,819
1,VIC,205,Glen Waverley Heights,386,49.23,398,50.77,784,99.37,5,0.63,789
1,VIC,205,Glen Waverley Lower,645,46.67,737,53.33,1382,99.14,12,0.86,1394
1,VIC,205,Glen Waverley North,491,49.3,505,50.7,996,98.81,12,1.19,1008
1,VIC,205,Glen Waverley South,973,49.39,997,50.61,1970,99.19,16,0.81,1986
1,VIC,205,Glen Waverley West,786,50.71,764,49.29,1550,98.92,17,1.08,1567
1,VIC,218,Glenburn,53,23.66,171,76.34,224,99.56,1,0.44,225
1,VIC,221,Glenferrie,448,68.92,202,31.08,650,99.39,4,0.61,654
1,VIC,213,Glengarry,124,24.6,380,75.4,504,98.82,6,1.18,510
1,VIC,198,Glenlyon,341,57.21,255,42.79,596,98.35,10,1.65,606
1,VIC,213,Glenmaggie,61,23.55,198,76.45,259,98.85,3,1.15,262
1,VIC,222,Glenorden,504,46.32,584,53.68,1088,98.37,18,1.63,1106
1,VIC,218,Glenrowan,136,37.26,229,62.74,365,99.18,3,0.82,368
1,VIC,234,Glenroy,990,55.21,803,44.79,1793,97.34,49,2.66,1842
1,VIC,234,Glenroy East,643,45.44,772,54.56,1415,98.13,27,1.87,1442
1,VIC,234,Glenroy North,490,54.02,417,45.98,907,98.37,15,1.63,922
1,VIC,234,Glenroy West,811,56.48,625,43.52,1436,98.36,24,1.64,1460
1,VIC,233,Glenthompson,25,23.36,82,76.64,107,100,0,0,107
1,VIC,213,Golden Beach,68,29.06,166,70.94,234,99.15,2,0.85,236
1,VIC,200,Golden Square,607,42.69,815,57.31,1422,98.75,18,1.25,1440
1,VIC,200,Golden Square South,197,42.73,264,57.27,461,98.93,5,1.07,466
1,VIC,218,Goorambat,35,17.5,165,82.5,200,100,0,0,200
1,VIC,200,Goornong,84,30.32,193,69.68,277,98.58,4,1.42,281
1,VIC,198,Gordon,260,40.06,389,59.94,649,98.63,9,1.37,658
1,VIC,213,Gormandale,72,19.78,292,80.22,364,99.18,3,0.82,367
1,VIC,224,Goroke,35,16.36,179,83.64,214,100,0,0,214
1,VIC,225,Gowanbrae,479,41.54,674,58.46,1153,98.97,12,1.03,1165
1,VIC,324,Gowrie,329,37.01,560,62.99,889,99.33,6,0.67,895
1,VIC,323,Grantville,265,32.08,561,67.92,826,98.22,15,1.78,841
1,VIC,224,Great Western,49,23.79,157,76.21,206,99.04,2,0.96,208
1,VIC,220,Greenhills,669,55.43,538,44.57,1207,99.34,8,0.66,1215
1,VIC,220,Greensborough,797,60.56,519,39.44,1316,97.77,30,2.23,1346
1,VIC,320,Greensborough COOPER PPVC,256,47.06,288,52.94,544,98.55,8,1.45,552
1,VIC,220,Greensborough JAGAJAGA PPVC,9373,45.27,11331,54.73,20704,99.05,198,0.95,20902
1,VIC,226,Greensborough MCEWEN PPVC,1906,38.04,3105,61.96,5011,99.03,49,0.97,5060
1,VIC,220,Greensborough North,709,50.97,682,49.03,1391,98.51,21,1.49,1412
1,VIC,232,Greensborough SCULLIN PPVC,299,40.13,446,59.87,745,98.94,8,1.06,753
1,VIC,203,Greenvale,985,34.84,1842,65.16,2827,98.57,41,1.43,2868
1,VIC,203,Greenvale South,651,30.38,1492,69.62,2143,98.66,29,1.34,2172
1,VIC,221,Greythorn,1108,53.24,973,46.76,2081,99.19,17,0.81,2098
1,VIC,328,Grovedale,1059,49.28,1090,50.72,2149,99.12,19,0.88,2168
1,VIC,328,Grovedale Central,599,47.5,662,52.5,1261,98.67,17,1.33,1278
1,VIC,328,Grovedale East,528,47.14,592,52.86,1120,98.68,15,1.32,1135
1,VIC,328,Grovedale West,874,44.55,1088,55.45,1962,98.84,23,1.16,1985
1,VIC,204,Gruyere,114,37.01,194,62.99,308,99.04,3,0.96,311
1,VIC,200,Guildford,132,60,88,40,220,98.21,4,1.79,224
1,VIC,324,Gunbower,42,15.91,222,84.09,264,98.51,4,1.49,268
1,VIC,324,Guthrie,326,32.41,680,67.59,1006,98.63,14,1.37,1020
1,VIC,198,Haddon,253,30.41,579,69.59,832,98.81,10,1.19,842
1,VIC,234,Hadfield,901,56.63,690,43.37,1591,98.09,31,1.91,1622
1,VIC,201,Hallam,906,50.9,874,49.1,1780,98.34,30,1.66,1810
1,VIC,201,Hallam East,505,48.98,526,51.02,1031,98.1,20,1.9,1051
1,VIC,224,Halls Gap,110,56.12,86,43.88,196,98,4,2,200
1,VIC,233,Hamilton,448,28.72,1112,71.28,1560,98.61,22,1.39,1582
1,VIC,233,Hamilton North,118,27,319,73,437,98.87,5,1.13,442
1,VIC,233,Hamilton PPVC,1564,23.44,5107,76.56,6671,99.14,58,0.86,6729
1,VIC,208,Hamlyn Heights,620,50.61,605,49.39,1225,98.39,20,1.61,1245
1,VIC,214,Hampton,927,64.83,503,35.17,1430,98.89,16,1.11,1446
1,VIC,214,Hampton Central,833,61.07,531,38.93,1364,99.42,8,0.58,1372
1,VIC,214,Hampton GOLDSTEIN PPVC,8271,54,7046,46,15317,99.26,114,0.74,15431
1,VIC,219,Hampton ISAACS PPVC,471,52.98,418,47.02,889,99.11,8,0.89,897
1,VIC,214,Hampton North,1013,62,621,38,1634,99.33,11,0.67,1645
1,VIC,216,Hampton Park,594,47.52,656,52.48,1250,97.96,26,2.04,1276
1,VIC,216,Hampton Park East,867,54.43,726,45.57,1593,98.58,23,1.42,1616
1,VIC,201,Hampton Park North (Bruce),175,53.03,155,46.97,330,98.51,5,1.49,335
1,VIC,216,Hampton Park North (Holt),600,47.06,675,52.94,1275,97.48,33,2.52,1308
1,VIC,216,Hampton Park South,747,51.09,715,48.91,1462,98.19,27,1.81,1489
1,VIC,200,Harcourt,265,49.44,271,50.56,536,98.53,8,1.47,544
1,VIC,201,Harkaway (Bruce),126,39.75,191,60.25,317,99.06,3,0.94,320
1,VIC,223,Harkaway (La Trobe),128,37.98,209,62.02,337,99.41,2,0.59,339
1,VIC,326,Harkness,453,44.02,576,55.98,1029,99.23,8,0.77,1037
1,VIC,218,Harrietville,72,61.02,46,38.98,118,97.52,3,2.48,121
1,VIC,224,Harrow,28,19.31,117,80.69,145,100,0,0,145
1,VIC,221,Hartwell,881,66.44,445,33.56,1326,99.55,6,0.45,1332
1,VIC,211,Hastings,587,37.7,970,62.3,1557,98.36,26,1.64,1583
1,VIC,211,Hastings PPVC,4971,35.76,8930,64.24,13901,99.03,136,0.97,14037
1,VIC,211,Hastings West,176,39.91,265,60.09,441,98.88,5,1.12,446
1,VIC,224,Haven,85,22.67,290,77.33,375,99.47,2,0.53,377
1,VIC,233,Hawkesdale,56,23.93,178,76.07,234,100,0,0,234
1,VIC,215,Hawksburn,1406,67.92,664,32.08,2070,99.42,12,0.58,2082
1,VIC,221,Hawthorn,1466,76.96,439,23.04,1905,99.06,18,0.94,1923
1,VIC,221,Hawthorn Central,1843,74.62,627,25.38,2470,99.48,13,0.52,2483
1,VIC,221,Hawthorn East Central,1393,73.32,507,26.68,1900,99.53,9,0.47,1909
1,VIC,221,Hawthorn East South,889,66.44,449,33.56,1338,99.11,12,0.89,1350
1,VIC,221,Hawthorn South,506,69.89,218,30.11,724,99.59,3,0.41,727
1,VIC,221,Hawthorn West,940,72.7,353,27.3,1293,99.08,12,0.92,1305
1,VIC,213,Hazelwood North,73,22.19,256,77.81,329,97.92,7,2.08,336
1,VIC,204,Healesville,169,47.74,185,52.26,354,98.06,7,1.94,361
1,VIC,204,Healesville Central,382,50.33,377,49.67,759,98.96,8,1.04,767
1,VIC,204,Healesville PPVC,2256,44.15,2854,55.85,5110,99.2,41,0.8,5151
1,VIC,200,Heathcote,464,28.36,1172,71.64,1636,98.14,31,1.86,1667
1,VIC,209,Heatherdale,591,63.82,335,36.18,926,99.25,7,0.75,933
1,VIC,209,Heathmont,472,54.32,397,45.68,869,98.64,12,1.36,881
1,VIC,209,Heathmont East,499,59.05,346,40.95,845,98.95,9,1.05,854
1,VIC,209,Heathmont North,1175,62.4,708,37.6,1883,98.9,21,1.1,1904
1,VIC,209,Heathmont West,538,60.31,354,39.69,892,99.22,7,0.78,899
1,VIC,220,Heidelberg,1293,66.68,646,33.32,1939,98.83,23,1.17,1962
1,VIC,320,Heidelberg COOPER PPVC,913,58.45,649,41.55,1562,99.17,13,0.83,1575
1,VIC,220,Heidelberg Heights,596,66.74,297,33.26,893,98.78,11,1.22,904
1,VIC,220,Heidelberg JAGAJAGA PPVC,8412,55.08,6859,44.92,15271,99.05,146,0.95,15417
1,VIC,221,Heidelberg KOOYONG PPVC,541,50.47,531,49.53,1072,99.54,5,0.46,1077
1,VIC,229,Heidelberg MENZIES PPVC,527,39.36,812,60.64,1339,99.26,10,0.74,1349
1,VIC,220,Heidelberg West,631,59.75,425,40.25,1056,98.51,16,1.49,1072
1,VIC,198,Hepburn Springs,438,60.5,286,39.5,724,99.18,6,0.82,730
1,VIC,208,Herne Hill,649,63.32,376,36.68,1025,99.13,9,0.87,1034
1,VIC,213,Heyfield,205,18.88,881,81.12,1086,99.36,7,0.64,1093
1,VIC,233,Heywood,179,23.19,593,76.81,772,99.23,6,0.77,778
1,VIC,214,Highett (Goldstein),841,63.71,479,36.29,1320,98.73,17,1.27,1337
1,VIC,219,Highett (Isaacs),183,62.46,110,37.54,293,99.32,2,0.68,295
1,VIC,214,Highett West,958,62.25,581,37.75,1539,99.23,12,0.77,1551
1,VIC,208,Highton,1025,57.49,758,42.51,1783,99.11,16,0.89,1799
1,VIC,208,Highton North,847,53.68,731,46.32,1578,98.87,18,1.13,1596
1,VIC,328,Highton South (Corangamite),118,50.86,114,49.14,232,97.07,7,2.93,239
1,VIC,208,Highton South (Corio),942,54.36,791,45.64,1733,98.58,25,1.42,1758
1,VIC,208,Highton West,1070,58.06,773,41.94,1843,98.77,23,1.23,1866
1,VIC,309,Hillside (Gorton),120,33.33,240,66.67,360,98.9,4,1.1,364
1,VIC,326,Hillside (Hawke),714,33.36,1426,66.64,2140,98.98,22,1.02,2162
1,VIC,309,Hillside South,690,34.69,1299,65.31,1989,98.81,24,1.19,2013
1,VIC,204,Hoddles Creek,142,37.57,236,62.43,378,99.47,2,0.53,380
1,VIC,224,Hopetoun,65,16.25,335,83.75,400,98.77,5,1.23,405
1,VIC,212,Hoppers Crossing GELLIBRAND PPVC,234,45.44,281,54.56,515,98.85,6,1.15,521
1,VIC,222,Hoppers Crossing LALOR PPVC,4329,43.88,5536,56.12,9865,98.88,112,1.12,9977
1,VIC,224,Horsham,282,28.6,704,71.4,986,99,10,1,996
1,VIC,224,Horsham East,214,26.35,598,73.65,812,98.78,10,1.22,822
1,VIC,224,Horsham North,141,25.87,404,74.13,545,99.09,5,0.91,550
1,VIC,224,Horsham PPVC,1899,18.91,8144,81.09,10043,99.37,64,0.63,10107
1,VIC,224,Horsham West,281,31.36,615,68.64,896,99.01,9,0.99,905
1,VIC,228,Hotham,808,81.45,184,18.55,992,98.9,11,1.1,1003
1,VIC,215,Hughesdale (Higgins),174,58.98,121,41.02,295,98.33,5,1.67,300
1,VIC,217,Hughesdale (Hotham),763,66.58,383,33.42,1146,99.48,6,0.52,1152
1,VIC,200,Huntly,412,31.33,903,68.67,1315,99.02,13,0.98,1328
1,VIC,226,Hurstbridge,876,55.34,707,44.66,1583,98.88,18,1.12,1601
1,VIC,224,Inglewood,134,22.37,465,77.63,599,99.83,1,0.17,600
1,VIC,324,Invergordon,50,20.49,194,79.51,244,99.59,1,0.41,245
1,VIC,328,Inverleigh,304,37.91,498,62.09,802,98.77,10,1.23,812
1,VIC,323,Inverloch,662,52.37,602,47.63,1264,99.22,10,0.78,1274
1,VIC,222,Iramoo,824,48.36,880,51.64,1704,98.55,25,1.45,1729
1,VIC,233,Irrewillipe,29,18.01,132,81.99,161,98.17,3,1.83,164
1,VIC,224,Irymple,225,21.19,837,78.81,1062,99.16,9,0.84,1071
1,VIC,220,Ivanhoe,1470,70.37,619,29.63,2089,99.05,20,0.95,2109
1,VIC,220,Ivanhoe East,1193,62.76,708,37.24,1901,99.37,12,0.63,1913
1,VIC,220,Ivanhoe South,695,68,327,32,1022,98.94,11,1.06,1033
1,VIC,218,Jamieson,43,31.62,93,68.38,136,98.55,2,1.45,138
1,VIC,205,Jells Park,549,48.71,578,51.29,1127,98.77,14,1.23,1141
1,VIC,224,Jeparit,69,29.11,168,70.89,237,98.75,3,1.25,240
1,VIC,323,Jindivick,60,30.15,139,69.85,199,98.03,4,1.97,203
1,VIC,213,Johnsonville,152,25.5,444,74.5,596,98.68,8,1.32,604
1,VIC,200,Junortoun,310,37.94,507,62.06,817,99.03,8,0.97,825
1,VIC,203,Kalkallo,832,56.56,639,43.44,1471,98.99,15,1.01,1486
1,VIC,204,Kallista,430,64.86,233,35.14,663,98.51,10,1.49,673
1,VIC,200,Kangaroo Flat,514,32.59,1063,67.41,1577,98.38,26,1.62,1603
1,VIC,200,Kangaroo Flat South,447,38.8,705,61.2,1152,99.05,11,0.95,1163
1,VIC,220,Kangaroo Ground (Jagajaga),275,51.31,261,48.69,536,99.81,1,0.19,537
1,VIC,226,Kangaroo Ground (McEwen),140,60.87,90,39.13,230,99.14,2,0.86,232
1,VIC,224,Kaniva,108,17.14,522,82.86,630,99.37,4,0.63,634
1,VIC,210,Karingal,741,47.47,820,52.53,1561,99.3,11,0.7,1572
1,VIC,210,Karingal Central,481,51.44,454,48.56,935,99.05,9,0.95,944
1,VIC,210,Karingal Heights,632,45.9,745,54.1,1377,98.08,27,1.92,1404
1,VIC,324,Katamatite,43,18.86,185,81.14,228,99.56,1,0.44,229
1,VIC,324,Katandra West,64,19.94,257,80.06,321,99.69,1,0.31,322
1,VIC,324,Katunga,59,15.73,316,84.27,375,99.47,2,0.53,377
1,VIC,321,Kealba,457,39.16,710,60.84,1167,98.07,23,1.93,1190
1,VIC,309,Keilor,488,32.25,1025,67.75,1513,98.76,19,1.24,1532
1,VIC,309,Keilor Downs,604,36.1,1069,63.9,1673,98.35,28,1.65,1701
1,VIC,309,Keilor Downs West,238,48.28,255,51.72,493,98.6,7,1.4,500
1,VIC,225,Keilor East,452,43.55,586,56.45,1038,98.39,17,1.61,1055
1,VIC,225,Keilor Heights,606,42.08,834,57.92,1440,98.16,27,1.84,1467
1,VIC,225,Keilor Park,180,50.56,176,49.44,356,99.16,3,0.84,359
1,VIC,225,Keilor South,537,42.38,730,57.62,1267,98.83,15,1.17,1282
1,VIC,309,Keilor Village,180,38.14,292,61.86,472,99.16,4,0.84,476
1,VIC,200,Kennington,561,48.95,585,51.05,1146,98.79,14,1.21,1160
1,VIC,225,Kensington,1314,84.39,243,15.61,1557,99.11,14,0.89,1571
1,VIC,225,Kensington Central,1421,82.95,292,17.05,1713,99.42,10,0.58,1723
1,VIC,224,Kerang,206,16.45,1046,83.55,1252,98.82,15,1.18,1267
1,VIC,224,Kerang North,150,17.46,709,82.54,859,98.96,9,1.04,868
1,VIC,322,Kerferd,738,62.92,435,37.08,1173,98.9,13,1.1,1186
1,VIC,323,Kernot,37,40.66,54,59.34,91,98.91,1,1.09,92
1,VIC,229,Kerrimuir,920,54.86,757,45.14,1677,99.35,11,0.65,1688
1,VIC,221,Kew,1796,66.74,895,33.26,2691,98.86,31,1.14,2722
1,VIC,221,Kew East,672,61.26,425,38.74,1097,99.46,6,0.54,1103
1,VIC,221,Kew East Central,1058,62.71,629,37.29,1687,99,17,1,1704
1,VIC,221,Kew North,742,59.55,504,40.45,1246,98.89,14,1.11,1260
1,VIC,221,Kew North West,496,65.44,262,34.56,758,99.48,4,0.52,762
1,VIC,221,Kew South,749,66.17,383,33.83,1132,99.39,7,0.61,1139
1,VIC,221,Kew West,700,56.77,533,43.23,1233,99.12,11,0.88,1244
1,VIC,219,Keysborough,1393,51.88,1292,48.12,2685,98.68,36,1.32,2721
1,VIC,217,Keysborough Central (Hotham),382,52.54,345,47.46,727,98.51,11,1.49,738
1,VIC,219,Keysborough Central (Isaacs),152,55.88,120,44.12,272,96.8,9,3.2,281
1,VIC,217,Keysborough East,493,51.89,457,48.11,950,97.84,21,2.16,971
1,VIC,219,Keysborough South,127,52.92,113,47.08,240,97.96,5,2.04,245
1,VIC,219,Keysborough West,85,52.47,77,47.53,162,99.39,1,0.61,163
1,VIC,324,Kialla,149,34.89,278,65.11,427,98.61,6,1.39,433
1,VIC,324,Kialla West,173,30.89,387,69.11,560,98.77,7,1.23,567
1,VIC,323,Kilcunda,134,52.34,122,47.66,256,99.22,2,0.78,258
1,VIC,326,Killara,563,44.79,694,55.21,1257,98.43,20,1.57,1277
1,VIC,226,Kilmore,489,34.95,910,65.05,1399,99.08,13,0.92,1412
1,VIC,226,Kilmore Central,341,36.67,589,63.33,930,99.15,8,0.85,938
1,VIC,204,Kilsyth (Casey),607,44.21,766,55.79,1373,98.56,20,1.44,1393
1,VIC,209,Kilsyth (Deakin),154,46.39,178,53.61,332,99.4,2,0.6,334
1,VIC,204,Kilsyth East,219,47.92,238,52.08,457,97.86,10,2.14,467
1,VIC,204,Kilsyth South,349,45.98,410,54.02,759,98.83,9,1.17,768
1,VIC,218,Kinglake,301,40.46,443,59.54,744,99.2,6,0.8,750
1,VIC,218,Kinglake West,303,35.36,554,64.64,857,98.73,11,1.27,868
1,VIC,309,Kings Park,450,52.08,414,47.92,864,98.18,16,1.82,880
1,VIC,309,Kings Park South,408,42.99,541,57.01,949,97.84,21,2.16,970
1,VIC,320,Kingsbury,552,50.83,534,49.17,1086,98.64,15,1.36,1101
1,VIC,219,Kingston Heath,677,51.96,626,48.04,1303,99.16,11,0.84,1314
1,VIC,321,Kingsville (Fraser),1196,79.15,315,20.85,1511,99.02,15,0.98,1526
1,VIC,212,Kingsville (Gellibrand),531,74.16,185,25.84,716,99.31,5,0.69,721
1,VIC,197,Knoxfield,610,42.16,837,57.84,1447,98.64,20,1.36,1467
1,VIC,197,Knoxfield Central,498,46.28,578,53.72,1076,99.08,10,0.92,1086
1,VIC,323,Kongwak,75,38.66,119,61.34,194,99.49,1,0.51,195
1,VIC,223,Koo Wee Rup,287,22.46,991,77.54,1278,98.31,22,1.69,1300
1,VIC,224,Koondrook,84,11.48,648,88.52,732,99.32,5,0.68,737
1,VIC,323,Koonwarra,136,37.47,227,62.53,363,98.91,4,1.09,367
1,VIC,224,Koorlong,50,19.84,202,80.16,252,99.6,1,0.4,253
1,VIC,233,Koroit,373,36.14,659,63.86,1032,98.66,14,1.34,1046
1,VIC,323,Korumburra,697,34.02,1352,65.98,2049,99.27,15,0.73,2064
1,VIC,326,Kurunjang,662,39.83,1000,60.17,1662,98.4,27,1.6,1689
1,VIC,324,Ky Valley,48,15.34,265,84.66,313,98.74,4,1.26,317
1,VIC,324,Kyabram,127,24.8,385,75.2,512,98.84,6,1.16,518
1,VIC,324,Kyabram PPVC,575,18.58,2520,81.42,3095,99.42,18,0.58,3113
1,VIC,324,Kyabram West,230,22.95,772,77.05,1002,98.43,16,1.57,1018
1,VIC,200,Kyneton,1041,55.85,823,44.15,1864,99.2,15,0.8,1879
1,VIC,200,Kyneton East,575,47.76,629,52.24,1204,99.75,3,0.25,1207
1,VIC,323,Labertouche,50,20.66,192,79.34,242,99.59,1,0.41,243
1,VIC,205,Laburnum,730,65.94,377,34.06,1107,99.28,8,0.72,1115
1,VIC,224,Lake Boga,61,16.67,305,83.33,366,98.65,5,1.35,371
1,VIC,233,Lake Bolac,57,21.92,203,78.08,260,100,0,0,260
1,VIC,224,Lake Charm,35,17.95,160,82.05,195,99.49,1,0.51,196
1,VIC,198,Lake Wendouree,968,61.42,608,38.58,1576,98.87,18,1.13,1594
1,VIC,213,Lakes Entrance,245,28.86,604,71.14,849,98.26,15,1.74,864
1,VIC,213,Lakes Entrance East,116,38.41,186,61.59,302,99.67,1,0.33,303
1,VIC,213,Lakes Entrance PPVC,1041,24.3,3243,75.7,4284,99.37,27,0.63,4311
1,VIC,232,Lalor,588,58.74,413,41.26,1001,98.23,18,1.77,1019
1,VIC,232,Lalor East,536,38.42,859,61.58,1395,97.69,33,2.31,1428
1,VIC,232,Lalor North,279,38.97,437,61.03,716,98.62,10,1.38,726
1,VIC,232,Lalor Park,334,45.63,398,54.37,732,97.86,16,2.14,748
1,VIC,232,Lalor West,716,38.06,1165,61.94,1881,97.51,48,2.49,1929
1,VIC,324,Lancaster,43,17,210,83,253,99.61,1,0.39,254
1,VIC,226,Lancefield,536,38.64,851,61.36,1387,98.79,17,1.21,1404
1,VIC,224,Landsborough,41,21.81,147,78.19,188,99.47,1,0.53,189
1,VIC,223,Lang Lang,269,24.32,837,75.68,1106,98.4,18,1.6,1124
1,VIC,210,Langwarrin,845,39.01,1321,60.99,2166,98.86,25,1.14,2191
1,VIC,210,Langwarrin Central,687,37.5,1145,62.5,1832,98.49,28,1.51,1860
1,VIC,210,Langwarrin North,568,43.1,750,56.9,1318,98.51,20,1.49,1338
1,VIC,210,Langwarrin Park,707,40.61,1034,59.39,1741,98.81,21,1.19,1762
1,VIC,208,Lara CBD,755,43.67,974,56.33,1729,98.41,28,1.59,1757
1,VIC,208,Lara Central,479,45.06,584,54.94,1063,98.98,11,1.02,1074
1,VIC,208,Lara East,85,51.83,79,48.17,164,98.8,2,1.2,166
1,VIC,208,Lara Lake,370,40.97,533,59.03,903,98.37,15,1.63,918
1,VIC,208,Lara PPVC,2191,33.77,4297,66.23,6488,99.13,57,0.87,6545
1,VIC,204,Launching Place,263,30.58,597,69.42,860,99.08,8,0.92,868
1,VIC,226,Laurimar,1076,40.12,1606,59.88,2682,98.46,42,1.54,2724
1,VIC,226,Laurimar Central,331,38,540,62,871,98.64,12,1.36,883
1,VIC,233,Lavers Hill,79,63.71,45,36.29,124,99.2,1,0.8,125
1,VIC,212,Laverton North,475,56.28,369,43.72,844,97.91,18,2.09,862
1,VIC,198,Learmonth,87,29.29,210,70.71,297,99,3,1,300
1,VIC,224,Leitchville,57,15.12,320,84.88,377,100,0,0,377
1,VIC,324,Lemnos,30,30.3,69,69.7,99,100,0,0,99
1,VIC,218,Leneva,92,38.82,145,61.18,237,99.58,1,0.42,238
1,VIC,323,Leongatha,605,31.94,1289,68.06,1894,98.7,25,1.3,1919
1,VIC,323,Leongatha East,435,35,808,65,1243,99.12,11,0.88,1254
1,VIC,323,Leongatha South,71,24.74,216,75.26,287,99.65,1,0.35,288
1,VIC,328,Leopold,1050,41.31,1492,58.69,2542,98.68,34,1.32,2576
1,VIC,328,Leopold North,495,47.41,549,52.59,1044,98.96,11,1.04,1055
1,VIC,198,Lethbridge,188,31.97,400,68.03,588,98.99,6,1.01,594
1,VIC,233,Lexton,59,32.24,124,67.76,183,100,0,0,183
1,VIC,204,Lilydale,697,43.13,919,56.87,1616,98.9,18,1.1,1634
1,VIC,204,Lilydale CASEY PPVC,4350,30.85,9750,69.15,14100,98.98,145,1.02,14245
1,VIC,209,Lilydale DEAKIN PPVC,0,0,0,0,0,0,0,0,0
1,VIC,204,Lilydale Lake,628,45.05,766,54.95,1394,99.08,13,0.92,1407
1,VIC,204,Lilydale North,363,45.72,431,54.28,794,98.15,15,1.85,809
1,VIC,204,Lilydale West,503,42.2,689,57.8,1192,98.59,17,1.41,1209
1,VIC,213,Lindenow,76,16.63,381,83.37,457,99.35,3,0.65,460
1,VIC,198,Linton,103,30.56,234,69.44,337,99.41,2,0.59,339
1,VIC,233,Lismore,57,19.86,230,80.14,287,97.62,7,2.38,294
1,VIC,222,Little River,103,39.31,159,60.69,262,100,0,0,262
1,VIC,323,Loch,125,36.98,213,63.02,338,99.71,1,0.29,339
1,VIC,213,Loch Sport,134,30.8,301,69.2,435,99.09,4,0.91,439
1,VIC,324,Lockington,95,18.74,412,81.26,507,99.22,4,0.78,511
1,VIC,200,Lockwood,213,36.1,377,63.9,590,98.99,6,1.01,596
1,VIC,200,Long Gully,119,40.34,176,59.66,295,100,0,0,295
1,VIC,213,Longford,93,32.63,192,67.37,285,98.96,3,1.04,288
1,VIC,323,Longwarry,270,26.29,757,73.71,1027,98.47,16,1.53,1043
1,VIC,324,Longwood,62,31.96,132,68.04,194,100,0,0,194
1,VIC,233,Lorne,298,62.34,180,37.66,478,98.76,6,1.24,484
1,VIC,220,Lower Plenty,614,51.68,574,48.32,1188,98.75,15,1.25,1203
1,VIC,198,Lucas,603,46.46,695,53.54,1298,99.01,13,0.99,1311
1,VIC,213,Lucknow,108,30.08,251,69.92,359,99.17,3,0.83,362
1,VIC,216,Lynbrook,737,49.63,748,50.37,1485,98.61,21,1.39,1506
1,VIC,201,Lynbrook BRUCE PPVC,471,39.78,713,60.22,1184,98.83,14,1.17,1198
1,VIC,216,Lynbrook HOLT PPVC,3969,44.23,5005,55.77,8974,98.95,95,1.05,9069
1,VIC,216,Lynbrook South,399,60,266,40,665,98.96,7,1.04,672
1,VIC,216,Lyndhurst,1138,54.22,961,45.78,2099,99.1,19,0.9,2118
1,VIC,197,Lysterfield,728,38.24,1176,61.76,1904,99.22,15,0.78,1919
1,VIC,233,Macarthur,55,18.33,245,81.67,300,99.67,1,0.33,301
1,VIC,204,Macclesfield,226,39.65,344,60.35,570,99.65,2,0.35,572
1,VIC,226,Macedon,545,61.24,345,38.76,890,99.33,6,0.67,896
1,VIC,220,Macleod,1201,63.08,703,36.92,1904,99.06,18,0.94,1922
1,VIC,326,Maddingley,634,40.41,935,59.59,1569,98.99,16,1.01,1585
1,VIC,213,Maffra,523,26.89,1422,73.11,1945,98.93,21,1.07,1966
1,VIC,198,Magpie,132,43.85,169,56.15,301,99.34,2,0.66,303
1,VIC,200,Maiden Gully,377,33.3,755,66.7,1132,99.21,9,0.79,1141
1,VIC,233,Mailors Flat,82,22.84,277,77.16,359,99.72,1,0.28,360
1,VIC,200,Maldon,445,51.86,413,48.14,858,98.96,9,1.04,867
1,VIC,213,Mallacoota,283,48.79,297,51.21,580,98.14,11,1.86,591
1,VIC,200,Malmsbury,364,54.01,310,45.99,674,98.68,9,1.32,683
1,VIC,215,Malvern,1480,60.41,970,39.59,2450,99.11,22,0.89,2472
1,VIC,215,Malvern Central,565,67.34,274,32.66,839,98.94,9,1.06,848
1,VIC,215,Malvern East,596,65.71,311,34.29,907,99.34,6,0.66,913
1,VIC,214,Malvern GOLDSTEIN PPVC,431,54.01,367,45.99,798,98.76,10,1.24,808
1,VIC,215,Malvern HIGGINS PPVC,10231,54.22,8640,45.78,18871,99.34,126,0.66,18997
1,VIC,221,Malvern KOOYONG PPVC,766,54.99,627,45.01,1393,99.36,9,0.64,1402
1,VIC,322,Malvern MACNAMARA PPVC,3735,58.57,2642,41.43,6377,98.82,76,1.18,6453
1,VIC,215,Malvern South,1183,64.96,638,35.04,1821,99.45,10,0.55,1831
1,VIC,224,Manangatang,15,8.72,157,91.28,172,100,0,0,172
1,VIC,200,Mandurang,235,46.72,268,53.28,503,99.41,3,0.59,506
1,VIC,208,Manifold Heights,871,63.35,504,36.65,1375,98.71,18,1.29,1393
1,VIC,222,Manor Lakes,1199,54.95,983,45.05,2182,99.27,16,0.73,2198
1,VIC,222,Manor Lakes PPVC,3374,48.88,3529,51.12,6903,99.27,51,0.73,6954
1,VIC,222,Manorvale,549,46.1,642,53.9,1191,97.94,25,2.06,1216
1,VIC,218,Mansfield,376,44.92,461,55.08,837,99.05,8,0.95,845
1,VIC,218,Mansfield PPVC,1515,32.16,3196,67.84,4711,99.28,34,0.72,4745
1,VIC,321,Maribyrnong,768,62.09,469,37.91,1237,98.64,17,1.36,1254
1,VIC,213,Marlo,111,38.81,175,61.19,286,98.28,5,1.72,291
1,VIC,200,Marong,202,29.15,491,70.85,693,99.28,5,0.72,698
1,VIC,224,Maryborough,297,27.2,795,72.8,1092,98.64,15,1.36,1107
1,VIC,224,Maryborough East,45,36.59,78,63.41,123,98.4,2,1.6,125
1,VIC,224,Maryborough PPVC,1408,23.26,4645,76.74,6053,99.21,48,0.79,6101
1,VIC,223,Maryknoll,119,32.51,247,67.49,366,99.46,2,0.54,368
1,VIC,218,Marysville,156,41.71,218,58.29,374,99.2,3,0.8,377
1,VIC,214,McKinnon,858,66.46,433,33.54,1291,99,13,1,1304
1,VIC,214,McKinnon East (Goldstein),1018,61.66,633,38.34,1651,98.92,18,1.08,1669
1,VIC,217,McKinnon East (Hotham),385,56.95,291,43.05,676,98.83,8,1.17,684
1,VIC,203,Meadow Heights,892,44.71,1103,55.29,1995,96.61,70,3.39,2065
1,VIC,203,Meadow Heights Central,232,45.14,282,54.86,514,96.44,19,3.56,533
1,VIC,203,Meadow Heights South,387,47.84,422,52.16,809,97.35,22,2.65,831
1,VIC,323,Meeniyan,185,31.41,404,68.59,589,98.83,7,1.17,596
1,VIC,322,Melbourne (Macnamara),22,64.71,12,35.29,34,100,0,0,34
1,VIC,225,Melbourne (Maribyrnong),38,66.67,19,33.33,57,100,0,0,57
1,VIC,228,Melbourne (Melbourne),623,75.98,197,24.02,820,99.03,8,0.97,828
1,VIC,234,Melbourne (Wills),16,72.73,6,27.27,22,100,0,0,22
1,VIC,203,Melbourne CALWELL PPVC,86,51.19,82,48.81,168,99.41,1,0.59,169
1,VIC,205,Melbourne CHISHOLM PPVC,72,58.06,52,41.94,124,100,0,0,124
1,VIC,320,Melbourne COOPER PPVC,218,81.34,50,18.66,268,99.26,2,0.74,270
1,VIC,209,Melbourne DEAKIN PPVC,53,65.43,28,34.57,81,100,0,0,81
1,VIC,321,Melbourne FRASER PPVC,719,80.16,178,19.84,897,99.12,8,0.88,905
1,VIC,212,Melbourne GELLIBRAND PPVC,169,63.06,99,36.94,268,99.26,2,0.74,270
1,VIC,214,Melbourne GOLDSTEIN PPVC,99,69.23,44,30.77,143,99.31,1,0.69,144
1,VIC,309,Melbourne GORTON PPVC,116,53.7,100,46.3,216,99.08,2,0.92,218
1,VIC,215,Melbourne HIGGINS PPVC,214,72.54,81,27.46,295,98.66,4,1.34,299
1,VIC,217,Melbourne HOTHAM PPVC,52,57.78,38,42.22,90,98.9,1,1.1,91
1,VIC,219,Melbourne ISAACS PPVC,65,69.15,29,30.85,94,97.92,2,2.08,96
1,VIC,220,Melbourne JAGAJAGA PPVC,96,64.43,53,35.57,149,99.33,1,0.67,150
1,VIC,221,Melbourne KOOYONG PPVC,151,62.66,90,37.34,241,98.77,3,1.23,244
1,VIC,222,Melbourne LALOR PPVC,96,64,54,36,150,100,0,0,150
1,VIC,322,Melbourne MACNAMARA PPVC,450,67.16,220,32.84,670,98.82,8,1.18,678
1,VIC,225,Melbourne MARIBYRNONG PPVC,1540,74.87,517,25.13,2057,99.47,11,0.53,2068
1,VIC,228,Melbourne MELBOURNE PPVC,7185,73.69,2565,26.31,9750,99.19,80,0.81,9830
1,VIC,229,Melbourne MENZIES PPVC,72,55.38,58,44.62,130,100,0,0,130
1,VIC,232,Melbourne SCULLIN PPVC,43,47.25,48,52.75,91,97.85,2,2.15,93
1,VIC,234,Melbourne WILLS PPVC,430,74.39,148,25.61,578,98.97,6,1.03,584
1,VIC,326,Melton,516,40.34,763,59.66,1279,98.54,19,1.46,1298
1,VIC,309,Melton GORTON PPVC,1022,43.9,1306,56.1,2328,99.4,14,0.6,2342
1,VIC,326,Melton HAWKE PPVC,5795,31.52,12591,68.48,18386,98.98,190,1.02,18576
1,VIC,326,Melton South,1045,49.57,1063,50.43,2108,98.05,42,1.95,2150
1,VIC,219,Mentone,854,65.19,456,34.81,1310,98.94,14,1.06,1324
1,VIC,219,Mentone North,388,54.49,324,45.51,712,98.48,11,1.52,723
1,VIC,219,Mentone Park,435,55.41,350,44.59,785,98.37,13,1.63,798
1,VIC,214,Mentone West (Goldstein),486,60.3,320,39.7,806,98.9,9,1.1,815
1,VIC,219,Mentone West (Isaacs),843,59.91,564,40.09,1407,99.29,10,0.71,1417
1,VIC,204,Menzies Creek,316,57.35,235,42.65,551,99.46,3,0.54,554
1,VIC,224,Merbein,223,22.06,788,77.94,1011,98.92,11,1.08,1022
1,VIC,198,Meredith,154,33.7,303,66.3,457,98.28,8,1.72,465
1,VIC,233,Merino,42,25.3,124,74.7,166,99.4,1,0.6,167
1,VIC,226,Mernda,765,43.49,994,56.51,1759,98.82,21,1.18,1780
1,VIC,226,Mernda Central (McEwen),595,44.21,751,55.79,1346,99.56,6,0.44,1352
1,VIC,232,Mernda Central (Scullin),485,44.09,615,55.91,1100,97.95,23,2.05,1123
1,VIC,232,Mernda Park,438,43.28,574,56.72,1012,98.35,17,1.65,1029
1,VIC,226,Mernda South,652,50.9,629,49.1,1281,98.84,15,1.16,1296
1,VIC,228,Merri,929,87.64,131,12.36,1060,98.97,11,1.03,1071
1,VIC,324,Merrigum,59,17.77,273,82.23,332,99.1,3,0.9,335
1,VIC,213,Metung,242,44.57,301,55.43,543,98.91,6,1.09,549
1,VIC,203,Mickleham,1108,53.55,961,46.45,2069,98.9,23,1.1,2092
1,VIC,203,Mickleham East,620,50.53,607,49.47,1227,99.27,9,0.73,1236
1,VIC,214,Middle Brighton,413,51.56,388,48.44,801,99.38,5,0.62,806
1,VIC,322,Middle Park,624,70.67,259,29.33,883,98.66,12,1.34,895
1,VIC,218,Milawa,133,36.44,232,63.56,365,98.92,4,1.08,369
1,VIC,224,Mildura,358,25.16,1065,74.84,1423,99.51,7,0.49,1430
1,VIC,224,Mildura City Central,470,28.4,1185,71.6,1655,98.69,22,1.31,1677
1,VIC,224,Mildura Deakin,212,29.73,501,70.27,713,99.03,7,0.97,720
1,VIC,224,Mildura MALLEE PPVC,1120,16.16,5812,83.84,6932,99.36,45,0.64,6977
1,VIC,224,Mildura South,212,27.39,562,72.61,774,99.1,7,0.9,781
1,VIC,224,Mildura South West,258,29.45,618,70.55,876,99.1,8,0.9,884
1,VIC,224,Mildura West,187,33.82,366,66.18,553,98.75,7,1.25,560
1,VIC,232,Mill Park,620,43.45,807,56.55,1427,98.14,27,1.86,1454
1,VIC,232,Mill Park Central,535,41.12,766,58.88,1301,98.64,18,1.36,1319
1,VIC,320,Mill Park COOPER PPVC,407,37.93,666,62.07,1073,99.44,6,0.56,1079
1,VIC,232,Mill Park East,677,36.75,1165,63.25,1842,98.61,26,1.39,1868
1,VIC,232,Mill Park Heights,654,37.87,1073,62.13,1727,98.4,28,1.6,1755
1,VIC,220,Mill Park JAGAJAGA PPVC,395,33.79,774,66.21,1169,98.82,14,1.18,1183
1,VIC,226,Mill Park MCEWEN PPVC,1490,31.13,3296,68.87,4786,99.23,37,0.77,4823
1,VIC,232,Mill Park North,395,40.47,581,59.53,976,98.19,18,1.81,994
1,VIC,232,Mill Park SCULLIN PPVC,5422,31.23,11939,68.77,17361,98.77,217,1.23,17578
1,VIC,232,Mill Park West,575,37.88,943,62.12,1518,98.25,27,1.75,1545
1,VIC,204,Millgrove,269,43.67,347,56.33,616,98.88,7,1.12,623
1,VIC,198,Miners Rest,378,32.9,771,67.1,1149,98.37,19,1.63,1168
1,VIC,224,Minyip,50,17.86,230,82.14,280,98.59,4,1.41,284
1,VIC,323,Mirboo North,515,42.77,689,57.23,1204,98.45,19,1.55,1223
1,VIC,209,Mitcham (Deakin),255,55.31,206,44.69,461,98.72,6,1.28,467
1,VIC,229,Mitcham (Menzies),465,55.49,373,44.51,838,99.17,7,0.83,845
1,VIC,209,Mitcham Lower,795,58.2,571,41.8,1366,99.2,11,0.8,1377
1,VIC,229,Mitcham North,1056,56.77,804,43.23,1860,98.57,27,1.43,1887
1,VIC,323,Moe,373,30.45,852,69.55,1225,98.79,15,1.21,1240
1,VIC,323,Moe Central,72,30.9,161,69.1,233,97.9,5,2.1,238
1,VIC,323,Moe PPVC,1822,25.51,5320,74.49,7142,99.32,49,0.68,7191
1,VIC,323,Moe West,221,30.27,509,69.73,730,99.18,6,0.82,736
1,VIC,204,Monbulk,874,50.43,859,49.57,1733,98.75,22,1.25,1755
1,VIC,221,Mont Albert,677,63.93,382,36.07,1059,99.06,10,0.94,1069
1,VIC,221,Mont Albert North,500,64.35,277,35.65,777,99.36,5,0.64,782
1,VIC,220,Montmorency,635,65.53,334,34.47,969,98.48,15,1.52,984
1,VIC,220,Montmorency South,1355,62.18,824,37.82,2179,99.23,17,0.77,2196
1,VIC,204,Montrose,864,47.81,943,52.19,1807,98.53,27,1.47,1834
1,VIC,204,Montrose South,274,47.32,305,52.68,579,99.31,4,0.69,583
1,VIC,328,Moolap,143,34.13,276,65.87,419,98.59,6,1.41,425
1,VIC,224,Moonambel,47,31.13,104,68.87,151,99.34,1,0.66,152
1,VIC,225,Moonee Ponds MARIBYRNONG PPVC,3526,65.7,1841,34.3,5367,99.15,46,0.85,5413
1,VIC,228,Moonee Ponds MELBOURNE PPVC,211,74.3,73,25.7,284,99.3,2,0.7,286
1,VIC,225,Moonee Ponds West,1114,67.35,540,32.65,1654,99.22,13,0.78,1667
1,VIC,234,Moonee Ponds WILLS PPVC,335,67.95,158,32.05,493,98.8,6,1.2,499
1,VIC,219,Moorabbin Central,342,57.97,248,42.03,590,99.33,4,0.67,594
1,VIC,214,Moorabbin GOLDSTEIN PPVC,2094,48.87,2191,51.13,4285,99.42,25,0.58,4310
1,VIC,217,Moorabbin HOTHAM PPVC,1428,45.67,1699,54.33,3127,99.14,27,0.86,3154
1,VIC,219,Moorabbin ISAACS PPVC,5338,47.93,5798,52.07,11136,99.07,105,0.93,11241
1,VIC,217,Moorabbin North,714,54.34,600,45.66,1314,99.02,13,0.98,1327
1,VIC,219,Moorabbin South,682,56.79,519,43.21,1201,98.69,16,1.31,1217
1,VIC,214,Moorabbin West (Goldstein),452,59.63,306,40.37,758,99.34,5,0.66,763
1,VIC,219,Moorabbin West (Isaacs),163,65.99,84,34.01,247,98.41,4,1.59,251
1,VIC,211,Moorooduc,206,45.27,249,54.73,455,98.27,8,1.73,463
1,VIC,204,Mooroolbark,231,54.35,194,45.65,425,99.3,3,0.7,428
1,VIC,204,Mooroolbark East,692,44.76,854,55.24,1546,98.72,20,1.28,1566
1,VIC,204,Mooroolbark North,542,46.25,630,53.75,1172,98.57,17,1.43,1189
1,VIC,204,Mooroolbark South,490,45.04,598,54.96,1088,98.82,13,1.18,1101
1,VIC,204,Mooroolbark Upper,478,42.41,649,57.59,1127,98.69,15,1.31,1142
1,VIC,204,Mooroolbark West,496,48.06,536,51.94,1032,99.04,10,0.96,1042
1,VIC,324,Mooroopna,217,28.59,542,71.41,759,99.09,7,0.91,766
1,VIC,324,Mooroopna Park,256,29.66,607,70.34,863,98.63,12,1.37,875
1,VIC,219,Mordialloc East,870,61.44,546,38.56,1416,99.16,12,0.84,1428
1,VIC,219,Mordialloc PPVC,8965,48.36,9572,51.64,18537,99,188,1,18725
1,VIC,234,Moreland,1325,78.96,353,21.04,1678,97.9,36,2.1,1714
1,VIC,234,Moreland South,1110,79.29,290,20.71,1400,99.22,11,0.78,1411
1,VIC,328,Moriac,374,53.66,323,46.34,697,99.01,7,0.99,704
1,VIC,211,Mornington,819,50.43,805,49.57,1624,99.02,16,0.98,1640
1,VIC,211,Mornington Central,400,57.39,297,42.61,697,98.45,11,1.55,708
1,VIC,210,Mornington DUNKLEY PPVC,1630,45.23,1974,54.77,3604,99.37,23,0.63,3627
1,VIC,211,Mornington East,913,45.74,1083,54.26,1996,98.96,21,1.04,2017
1,VIC,211,Mornington FLINDERS PPVC,6762,41.22,9641,58.78,16403,99.24,125,0.76,16528
1,VIC,211,Mornington Park,489,47.38,543,52.62,1032,98.85,12,1.15,1044
1,VIC,211,Mornington South,334,58.19,240,41.81,574,98.63,8,1.37,582
1,VIC,233,Mortlake,232,28.61,579,71.39,811,99.63,3,0.37,814
1,VIC,213,Morwell,455,31.64,983,68.36,1438,98.83,17,1.17,1455
1,VIC,213,Morwell Estate,303,28.53,759,71.47,1062,98.24,19,1.76,1081
1,VIC,213,Morwell GIPPSLAND PPVC,2395,25.65,6943,74.35,9338,99.11,84,0.89,9422
1,VIC,323,Morwell MONASH PPVC,350,28.95,859,71.05,1209,99.18,10,0.82,1219
1,VIC,222,Mossfiel,713,51.67,667,48.33,1380,98.36,23,1.64,1403
1,VIC,218,Mount Beauty,557,53.35,487,46.65,1044,99.05,10,0.95,1054
1,VIC,198,Mount Clear,763,54.04,649,45.96,1412,99.09,13,0.91,1425
1,VIC,204,Mount Dandenong,481,63.96,271,36.04,752,99.08,7,0.92,759
1,VIC,328,Mount Duneed,330,48.1,356,51.9,686,98.71,9,1.29,695
1,VIC,328,Mount Duneed Upper,885,55.73,703,44.27,1588,99.19,13,0.81,1601
1,VIC,323,Mount Eccles,47,31.33,103,68.67,150,98.04,3,1.96,153
1,VIC,198,Mount Egerton,134,39.64,204,60.36,338,98.83,4,1.17,342
1,VIC,210,Mount Eliza,786,52.79,703,47.21,1489,99.13,13,0.87,1502
1,VIC,210,Mount Eliza Central,267,50.76,259,49.24,526,99.43,3,0.57,529
1,VIC,210,Mount Eliza North,379,57.51,280,42.49,659,98.8,8,1.2,667
1,VIC,210,Mount Eliza South,881,60.59,573,39.41,1454,98.91,16,1.09,1470
1,VIC,210,Mount Eliza West,579,56.71,442,43.29,1021,99.13,9,0.87,1030
1,VIC,204,Mount Evelyn,570,46.49,656,53.51,1226,98.87,14,1.13,1240
1,VIC,204,Mount Evelyn West,666,39.53,1019,60.47,1685,98.14,32,1.86,1717
1,VIC,226,Mount Macedon,362,60.03,241,39.97,603,99.18,5,0.82,608
1,VIC,211,Mount Martha,1032,61.72,640,38.28,1672,99.17,14,0.83,1686
1,VIC,211,Mount Martha Nepean,176,63.54,101,36.46,277,99.64,1,0.36,278
1,VIC,211,Mount Martha North,903,49.67,915,50.33,1818,98.54,27,1.46,1845
1,VIC,198,Mount Pleasant,487,53.58,422,46.42,909,99.24,7,0.76,916
1,VIC,203,Mount Ridley,915,49.59,930,50.41,1845,98.77,23,1.23,1868
1,VIC,205,Mount Waverley,524,55.33,423,44.67,947,99.06,9,0.94,956
1,VIC,205,Mount Waverley CHISHOLM PPVC,5065,50.29,5007,49.71,10072,99.31,70,0.69,10142
1,VIC,209,Mount Waverley DEAKIN PPVC,168,49.12,174,50.88,342,99.42,2,0.58,344
1,VIC,217,Mount Waverley HOTHAM PPVC,0,0,0,0,0,0,0,0,0
1,VIC,205,Mount Waverley Lower,481,50.42,473,49.58,954,99.27,7,0.73,961
1,VIC,205,Mount Waverley North,653,55.81,517,44.19,1170,98.9,13,1.1,1183
1,VIC,205,Mount Waverley South,940,52.72,843,47.28,1783,98.62,25,1.38,1808
1,VIC,205,Mount Waverley Upper,329,51.41,311,48.59,640,99.69,2,0.31,642
1,VIC,205,Mount Waverley West,819,51.67,766,48.33,1585,99.44,9,0.56,1594
1,VIC,218,Moyhu,102,31.19,225,68.81,327,99.7,1,0.3,328
1,VIC,233,Moyston,96,35.69,173,64.31,269,99.63,1,0.37,270
1,VIC,218,Mudgegonga,56,28.72,139,71.28,195,99.49,1,0.51,196
1,VIC,205,Mulgrave (Chisholm),140,49.3,144,50.7,284,99.65,1,0.35,285
1,VIC,217,Mulgrave (Hotham),432,49.32,444,50.68,876,98.65,12,1.35,888
1,VIC,201,Mulgrave BRUCE PPVC,588,40,882,60,1470,98.92,16,1.08,1486
1,VIC,217,Mulgrave Central,546,44.1,692,55.9,1238,98.65,17,1.35,1255
1,VIC,205,Mulgrave CHISHOLM PPVC,3456,41.47,4878,58.53,8334,99.3,59,0.7,8393
1,VIC,201,Mulgrave East (Bruce),593,43.93,757,56.07,1350,99.19,11,0.81,1361
1,VIC,217,Mulgrave East (Hotham),281,51.47,265,48.53,546,99.64,2,0.36,548
1,VIC,217,Mulgrave HOTHAM PPVC,3105,44.33,3899,55.67,7004,99.15,60,0.85,7064
1,VIC,217,Mulgrave South,309,50,309,50,618,97.63,15,2.37,633
1,VIC,324,Murchison,163,27.91,421,72.09,584,98.65,8,1.35,592
1,VIC,224,Murrabit,25,13.44,161,86.56,186,98.41,3,1.59,189
1,VIC,320,Murray (Cooper),482,68.27,224,31.73,706,98.47,11,1.53,717
1,VIC,234,Murray (Wills),102,60,68,40,170,98.84,2,1.16,172
1,VIC,224,Murrayville,33,16.42,168,83.58,201,97.57,5,2.43,206
1,VIC,215,Murrumbeena (Higgins),868,66.72,433,33.28,1301,99.46,7,0.54,1308
1,VIC,217,Murrumbeena (Hotham),93,64.14,52,35.86,145,100,0,0,145
1,VIC,215,Murrumbeena South,938,67.39,454,32.61,1392,99.15,12,0.85,1404
1,VIC,224,Murtoa,131,32.03,278,67.97,409,99.27,3,0.73,412
1,VIC,326,Myrniong,119,37.42,199,62.58,318,99.38,2,0.63,320
1,VIC,218,Myrtleford,441,34.45,839,65.55,1280,98.69,17,1.31,1297
1,VIC,324,Nagambie,261,26.02,742,73.98,1003,99.31,7,0.69,1010
1,VIC,213,Nambrok,34,16.11,177,83.89,211,99.06,2,0.94,213
1,VIC,224,Nangiloc,29,17.68,135,82.32,164,99.39,1,0.61,165
1,VIC,324,Nanneella,41,17.45,194,82.55,235,99.16,2,0.84,237
1,VIC,198,Napoleons,202,40.97,291,59.03,493,99,5,1,498
1,VIC,223,Nar Nar Goon,115,24.26,359,75.74,474,98.75,6,1.25,480
1,VIC,223,Nar Nar Goon North,84,32.43,175,67.57,259,99.62,1,0.38,260
1,VIC,218,Narbethong,50,27.78,130,72.22,180,98.9,2,1.1,182
1,VIC,323,Narracan,43,28.29,109,71.71,152,98.06,3,1.94,155
1,VIC,233,Narrawong,111,45.31,134,54.69,245,97.22,7,2.78,252
1,VIC,201,Narre Warren,801,45.8,948,54.2,1749,98.81,21,1.19,1770
1,VIC,201,Narre Warren Central,673,41.19,961,58.81,1634,98.61,23,1.39,1657
1,VIC,201,Narre Warren North,432,30.79,971,69.21,1403,98.8,17,1.2,1420
1,VIC,216,Narre Warren South,1190,45.96,1399,54.04,2589,98.63,36,1.37,2625
1,VIC,216,Narre Warren South Central,498,47.61,548,52.39,1046,98.68,14,1.32,1060
1,VIC,201,Narre Warren South East (Bruce),1132,45.44,1359,54.56,2491,98.69,33,1.31,2524
1,VIC,216,Narre Warren South East (Holt),122,45.69,145,54.31,267,100,0,0,267
1,VIC,201,Narre Warren West,906,43.27,1188,56.73,2094,98.54,31,1.46,2125
1,VIC,324,Nathalia,215,22.4,745,77.6,960,99.79,2,0.21,962
1,VIC,224,Natimuk,90,31.03,200,68.97,290,99.32,2,0.68,292
1,VIC,323,Neerim South,250,31.49,544,68.51,794,99.37,5,0.63,799
1,VIC,233,Nelson,25,21.93,89,78.07,114,99.13,1,0.87,115
1,VIC,323,Nerrena,67,26.38,187,73.62,254,99.22,2,0.78,256
1,VIC,226,New Gisborne,626,46.93,708,53.07,1334,98.81,16,1.19,1350
1,VIC,323,Newborough,142,35.15,262,64.85,404,99.02,4,0.98,408
1,VIC,323,Newborough East,256,28.01,658,71.99,914,99.46,5,0.54,919
1,VIC,224,Newbridge,49,21.03,184,78.97,233,98.73,3,1.27,236
1,VIC,208,Newcomb,491,42.25,671,57.75,1162,98.56,17,1.44,1179
1,VIC,208,Newcomb South,364,42.72,488,57.28,852,98.61,12,1.39,864
1,VIC,226,Newham,242,51.38,229,48.62,471,99.58,2,0.42,473
1,VIC,323,Newhaven,349,60.28,230,39.72,579,98.47,9,1.53,588
1,VIC,198,Newington,433,57.05,326,42.95,759,98.44,12,1.56,771
1,VIC,320,Newlands,897,76.54,275,23.46,1172,98.9,13,1.1,1185
1,VIC,213,Newlands Arm,90,33.96,175,66.04,265,99.25,2,0.75,267
1,VIC,198,Newlyn,259,41.91,359,58.09,618,99.36,4,0.64,622
1,VIC,213,Newmerella,63,16.67,315,83.33,378,99.21,3,0.79,381
1,VIC,212,Newport,985,69.42,434,30.58,1419,98.54,21,1.46,1440
1,VIC,212,Newport PPVC,8445,51.8,7859,48.2,16304,99.05,156,0.95,16460
1,VIC,212,Newport West,819,67.13,401,32.87,1220,99.51,6,0.49,1226
1,VIC,200,Newstead,300,54.84,247,45.16,547,98.03,11,1.97,558
1,VIC,208,Newtown,960,63.07,562,36.93,1522,98.96,16,1.04,1538
1,VIC,208,Newtown South,1485,64.17,829,35.83,2314,99.1,21,0.9,2335
1,VIC,224,Nhill,225,20.55,870,79.45,1095,99.01,11,0.99,1106
1,VIC,224,Nichols Point,106,28.12,271,71.88,377,99.47,2,0.53,379
1,VIC,225,Niddrie Central,610,47.58,672,52.42,1282,98.39,21,1.61,1303
1,VIC,323,Nilma,198,35.93,353,64.07,551,98.04,11,1.96,562
1,VIC,217,Noble Park,845,59.76,569,40.24,1414,98.19,26,1.81,1440
1,VIC,201,Noble Park BRUCE PPVC,323,45.05,394,54.95,717,98.76,9,1.24,726
1,VIC,217,Noble Park HOTHAM PPVC,6719,47.99,7282,52.01,14001,98.9,156,1.1,14157
1,VIC,219,Noble Park ISAACS PPVC,2026,46.92,2292,53.08,4318,99.24,33,0.76,4351
1,VIC,217,Noble Park Lower,732,52.85,653,47.15,1385,97.95,29,2.05,1414
1,VIC,201,Noble Park North (Bruce),537,48.08,580,51.92,1117,98.41,18,1.59,1135
1,VIC,217,Noble Park North (Hotham),188,52.51,170,47.49,358,98.9,4,1.1,362
1,VIC,201,Noble Park North Upper (Bruce),109,44.31,137,55.69,246,97.62,6,2.38,252
1,VIC,217,Noble Park North Upper (Hotham),244,40.6,357,59.4,601,98.2,11,1.8,612
1,VIC,217,Noble Park Upper,694,53.18,611,46.82,1305,98.34,22,1.66,1327
1,VIC,217,Noble Park West,399,55.8,316,44.2,715,98.08,14,1.92,729
1,VIC,323,Noojee,66,35.87,118,64.13,184,100,0,0,184
1,VIC,233,Noorat,89,25.07,266,74.93,355,99.44,2,0.56,357
1,VIC,208,Norlane,757,37.48,1263,62.52,2020,98.97,21,1.03,2041
1,VIC,228,North Melbourne,920,76.54,282,23.46,1202,99.42,7,0.58,1209
1,VIC,228,North Melbourne Central,1233,81.82,274,18.18,1507,99.54,7,0.46,1514
1,VIC,208,North Shore,349,42.51,472,57.49,821,98.56,12,1.44,833
1,VIC,229,North Warrandyte,463,71.01,189,28.99,652,98.79,8,1.21,660
1,VIC,320,Northcote,877,92.22,74,7.78,951,99.89,1,0.11,952
1,VIC,320,Northcote Central,969,79.62,248,20.38,1217,98.86,14,1.14,1231
1,VIC,320,Northcote COOPER PPVC,12182,69.15,5436,30.85,17618,99.03,173,0.97,17791
1,VIC,228,Northcote MELBOURNE PPVC,1727,77.72,495,22.28,2222,99.29,16,0.71,2238
1,VIC,320,Northcote North,939,79.24,246,20.76,1185,99,12,1,1197
1,VIC,320,Northcote South,1668,82.9,344,17.1,2012,99.21,16,0.79,2028
1,VIC,320,Northcote West,536,90.39,57,9.61,593,99.5,3,0.5,596
1,VIC,234,Northcote WILLS PPVC,1134,69.91,488,30.09,1622,99.45,9,0.55,1631
1,VIC,213,Nowa Nowa,30,25.21,89,74.79,119,100,0,0,119
1,VIC,233,Nullawarre,65,21.81,233,78.19,298,99,3,1,301
1,VIC,324,Numurkah,469,23.84,1498,76.16,1967,99.04,19,0.96,1986
1,VIC,209,Nunawading South,909,58.8,637,41.2,1546,99.42,9,0.58,1555
1,VIC,224,Nyah,47,18.22,211,81.78,258,99.61,1,0.39,259
1,VIC,224,Nyah West,26,13,174,87,200,100,0,0,200
1,VIC,323,Nyora,148,21.42,543,78.58,691,99.42,4,0.58,695
1,VIC,234,Oak Park,1050,59.9,703,40.1,1753,98.87,20,1.13,1773
1,VIC,234,Oak Park West,568,60.04,378,39.96,946,98.13,18,1.87,964
1,VIC,205,Oakleigh (Chisholm),190,50,190,50,380,99.48,2,0.52,382
1,VIC,217,Oakleigh (Hotham),784,51.95,725,48.05,1509,98.76,19,1.24,1528
1,VIC,217,Oakleigh Central,497,59.88,333,40.12,830,98.22,15,1.78,845
1,VIC,205,Oakleigh CHISHOLM PPVC,1334,44.53,1662,55.47,2996,99.07,28,0.93,3024
1,VIC,205,Oakleigh East (Chisholm),274,47.49,303,52.51,577,98.97,6,1.03,583
1,VIC,217,Oakleigh East (Hotham),466,52.77,417,47.23,883,98.77,11,1.23,894
1,VIC,214,Oakleigh GOLDSTEIN PPVC,401,47.4,445,52.6,846,99.3,6,0.7,852
1,VIC,215,Oakleigh HIGGINS PPVC,2669,56.24,2077,43.76,4746,98.94,51,1.06,4797
1,VIC,217,Oakleigh HOTHAM PPVC,5976,46.88,6772,53.12,12748,98.87,146,1.13,12894
1,VIC,217,Oakleigh South,605,64.09,339,35.91,944,98.23,17,1.77,961
1,VIC,328,Ocean Grove,889,64.14,497,35.86,1386,99,14,1,1400
1,VIC,328,Ocean Grove PPVC,5528,51.77,5149,48.23,10677,99.25,81,0.75,10758
1,VIC,328,Ocean Grove South,787,65.91,407,34.09,1194,99,12,1,1206
1,VIC,328,Ocean Grove West,541,63.57,310,36.43,851,99.42,5,0.58,856
1,VIC,223,Officer,390,46.99,440,53.01,830,99.28,6,0.72,836
1,VIC,223,Officer Central,1259,50.5,1234,49.5,2493,99.01,25,0.99,2518
1,VIC,223,Officer North,540,49.5,551,50.5,1091,98.82,13,1.18,1104
1,VIC,204,Olinda,292,62,179,38,471,99.37,3,0.63,474
1,VIC,220,Olympic Village,794,63.02,466,36.98,1260,98.44,20,1.56,1280
1,VIC,213,Omeo,74,23.42,242,76.58,316,97.83,7,2.17,323
1,VIC,213,Orbost,215,23.12,715,76.88,930,98.62,13,1.38,943
1,VIC,214,Ormond West,1055,66.35,535,33.65,1590,99.19,13,0.81,1603
1,VIC,324,Orrvale,95,23.51,309,76.49,404,99.51,2,0.49,406
1,VIC,213,Other Mobile Team 1,55,50.46,54,49.54,109,99.09,1,0.91,110
1,VIC,210,Other Mobile Team 1,8,88.89,1,11.11,9,100,0,0,9
1,VIC,200,Other Mobile Team 1,162,64.8,88,35.2,250,99.6,1,0.4,251
1,VIC,232,Other Mobile Team 1,2,50,2,50,4,100,0,0,4
1,VIC,324,Other Mobile Team 1,12,25,36,75,48,100,0,0,48
1,VIC,222,Other Mobile Team 1,28,84.85,5,15.15,33,100,0,0,33
1,VIC,326,Other Mobile Team 1,14,70,6,30,20,90.91,2,9.09,22
1,VIC,218,Other Mobile Team 1,9,39.13,14,60.87,23,100,0,0,23
1,VIC,224,Other Mobile Team 1,63,62.38,38,37.62,101,100,0,0,101
1,VIC,228,Other Mobile Team 1,6,85.71,1,14.29,7,100,0,0,7
1,VIC,208,Other Mobile Team 1,101,63.13,59,36.88,160,99.38,1,0.62,161
1,VIC,233,Other Mobile Team 1,0,0,0,0,0,0,0,0,0
1,VIC,198,Other Mobile Team 1,117,86.67,18,13.33,135,100,0,0,135
1,VIC,212,Other Mobile Team 1,0,0,0,0,0,0,0,0,0
1,VIC,309,Other Mobile Team 1,0,0,0,0,0,0,0,0,0
1,VIC,213,Other Mobile Team 2,4,44.44,5,55.56,9,100,0,0,9
1,VIC,224,Outer Mildura PPVC,2523,20.91,9542,79.09,12065,99.37,76,0.63,12141
1,VIC,224,Ouyen,125,17.53,588,82.47,713,98.07,14,1.93,727
1,VIC,223,Pakenham,481,41.08,690,58.92,1171,98.57,17,1.43,1188
1,VIC,223,Pakenham Central,933,42.68,1253,57.32,2186,98.87,25,1.13,2211
1,VIC,223,Pakenham East,235,48.65,248,51.35,483,97.97,10,2.03,493
1,VIC,223,Pakenham Heights,158,37,269,63,427,98.39,7,1.61,434
1,VIC,223,Pakenham LA TROBE PPVC,5440,31.49,11834,68.51,17274,98.95,183,1.05,17457
1,VIC,323,Pakenham MONASH PPVC,128,24.47,395,75.53,523,99.43,3,0.57,526
1,VIC,223,Pakenham North,662,38.87,1041,61.13,1703,98.72,22,1.28,1725
1,VIC,223,Pakenham Shearwater,1431,45.57,1709,54.43,3140,99.02,31,0.98,3171
1,VIC,223,Pakenham Springs,933,43.84,1195,56.16,2128,98.79,26,1.21,2154
1,VIC,223,Pakenham Upper,146,33.33,292,66.67,438,99.77,1,0.23,439
1,VIC,223,Pakenham Voting Day PPVC,0,0,0,0,0,0,0,0,0
1,VIC,223,Pakenham West,166,42.89,221,57.11,387,99.49,2,0.51,389
1,VIC,233,Panmure,77,27.02,208,72.98,285,99.3,2,0.7,287
1,VIC,226,Panton Hill,335,50.76,325,49.24,660,99.1,6,0.9,666
1,VIC,229,Park Orchards,635,50.36,626,49.64,1261,98.98,13,1.02,1274
1,VIC,219,Parkdale,1005,61.13,639,38.87,1644,98.98,17,1.02,1661
1,VIC,219,Parkdale Central,466,61.72,289,38.28,755,99.6,3,0.4,758
1,VIC,219,Parkdale East,986,58.69,694,41.31,1680,99,17,1,1697
1,VIC,228,Parkville,909,80.94,214,19.06,1123,99.56,5,0.44,1128
1,VIC,234,Pascoe Vale,695,62.5,417,37.5,1112,99.55,5,0.45,1117
1,VIC,203,Pascoe Vale CALWELL PPVC,83,42.78,111,57.22,194,97,6,3,200
1,VIC,234,Pascoe Vale Central,299,53.68,258,46.32,557,99.29,4,0.71,561
1,VIC,225,Pascoe Vale MARIBYRNONG PPVC,219,64.22,122,35.78,341,99.13,3,0.87,344
1,VIC,234,Pascoe Vale Middle,722,63.33,418,36.67,1140,98.28,20,1.72,1160
1,VIC,234,Pascoe Vale North,1071,54.73,886,45.27,1957,98.69,26,1.31,1983
1,VIC,234,Pascoe Vale South,981,58.6,693,41.4,1674,99.23,13,0.77,1687
1,VIC,234,Pascoe Vale WILLS PPVC,9852,69.51,4322,30.49,14174,99.14,123,0.86,14297
1,VIC,219,Patterson Central,492,40.07,736,59.93,1228,98.48,19,1.52,1247
1,VIC,219,Patterson Lakes,481,41.54,677,58.46,1158,99.06,11,0.94,1169
1,VIC,213,Paynesville,333,35.5,605,64.5,938,99.36,6,0.64,944
1,VIC,216,Pearcedale,504,31.66,1088,68.34,1592,98.45,25,1.55,1617
1,VIC,233,Penshurst,69,19.88,278,80.12,347,98.86,4,1.14,351
1,VIC,326,Pentland Hills,281,45.03,343,54.97,624,99.05,6,0.95,630
1,VIC,233,Peterborough,76,37.07,129,62.93,205,97.16,6,2.84,211
1,VIC,224,Piangil,21,13.21,138,86.79,159,100,0,0,159
1,VIC,324,Picola,43,13.52,275,86.48,318,99.07,3,0.93,321
1,VIC,205,Pinewood,1191,51.42,1125,48.58,2316,98.72,30,1.28,2346
1,VIC,226,Plenty,337,36.2,594,63.8,931,99.04,9,0.96,940
1,VIC,212,Point Cook,845,51.81,786,48.19,1631,99.09,15,0.91,1646
1,VIC,212,Point Cook Central,932,47.43,1033,52.57,1965,98.94,21,1.06,1986
1,VIC,212,Point Cook GELLIBRAND PPVC,6599,44.38,8269,55.62,14868,99.19,121,0.81,14989
1,VIC,222,Point Cook LALOR PPVC,1220,51.26,1160,48.74,2380,99.29,17,0.71,2397
1,VIC,212,Point Cook North,519,55.75,412,44.25,931,99.47,5,0.53,936
1,VIC,212,Point Cook West (Gellibrand),565,56.61,433,43.39,998,99.4,6,0.6,1004
1,VIC,222,Point Cook West (Lalor),251,56.79,191,43.21,442,99.55,2,0.45,444
1,VIC,328,Point Lonsdale,776,65.54,408,34.46,1184,99.41,7,0.59,1191
1,VIC,323,Poowong,141,30.45,322,69.55,463,98.93,5,1.07,468
1,VIC,218,Porepunkah,136,46.74,155,53.26,291,99.66,1,0.34,292
1,VIC,213,Port Albert,73,29.8,172,70.2,245,98.79,3,1.21,248
1,VIC,233,Port Campbell,112,45.53,134,54.47,246,99.6,1,0.4,247
1,VIC,233,Port Fairy,717,51.51,675,48.49,1392,99,14,1,1406
1,VIC,323,Port Franklin,66,34.2,127,65.8,193,98.47,3,1.53,196
1,VIC,322,Port Melbourne,708,61.89,436,38.11,1144,98.88,13,1.12,1157
1,VIC,322,Port Melbourne Beach,662,64.52,364,35.48,1026,98.84,12,1.16,1038
1,VIC,215,Port Melbourne HIGGINS PPVC,371,61.02,237,38.98,608,99.18,5,0.82,613
1,VIC,322,Port Melbourne MACNAMARA PPVC,9126,59.52,6207,40.48,15333,99.17,128,0.83,15461
1,VIC,322,Port Melbourne West,668,65.04,359,34.96,1027,99.23,8,0.77,1035
1,VIC,328,Portarlington,675,43.49,877,56.51,1552,99.3,11,0.7,1563
1,VIC,233,Portland Central,483,33.2,972,66.8,1455,98.58,21,1.42,1476
1,VIC,233,Portland North,58,31.02,129,68.98,187,99.47,1,0.53,188
1,VIC,233,Portland PPVC,1606,23.61,5197,76.39,6803,99.21,54,0.79,6857
1,VIC,233,Portland South,129,41.75,180,58.25,309,100,0,0,309
1,VIC,211,Portsea,83,46.37,96,53.63,179,99.44,1,0.56,180
1,VIC,215,Prahran (Higgins),836,71.15,339,28.85,1175,99.41,7,0.59,1182
1,VIC,322,Prahran (Macnamara),279,68.05,131,31.95,410,98.56,6,1.44,416
1,VIC,215,Prahran East,846,74.54,289,25.46,1135,98.95,12,1.05,1147
1,VIC,215,Prahran North East,899,74.92,301,25.08,1200,99.5,6,0.5,1206
1,VIC,320,Preston,576,65.53,303,34.47,879,98.88,10,1.12,889
1,VIC,320,Preston COOPER PPVC,6701,58.42,4770,41.58,11471,99.22,90,0.78,11561
1,VIC,320,Preston East,791,64.31,439,35.69,1230,98.8,15,1.2,1245
1,VIC,220,Preston JAGAJAGA PPVC,313,59.17,216,40.83,529,98.88,6,1.12,535
1,VIC,320,Preston North East,638,59.57,433,40.43,1071,98.44,17,1.56,1088
1,VIC,232,Preston SCULLIN PPVC,252,44.29,317,55.71,569,98.96,6,1.04,575
1,VIC,320,Preston South,558,74.2,194,25.8,752,99.6,3,0.4,755
1,VIC,320,Preston West,881,64.21,491,35.79,1372,98.92,15,1.08,1387
1,VIC,228,Princes Hill,1223,87.11,181,12.89,1404,99.57,6,0.43,1410
1,VIC,233,Princetown,28,19.72,114,80.28,142,100,0,0,142
1,VIC,324,Puckapunyal,49,25.39,144,74.61,193,99.48,1,0.52,194
1,VIC,233,Purnim,42,19.27,176,80.73,218,98.2,4,1.8,222
1,VIC,324,Pyalong,69,22.04,244,77.96,313,98.74,4,1.26,317
1,VIC,224,Pyramid Hill,72,18.75,312,81.25,384,98.71,5,1.29,389
1,VIC,224,Quambatook,29,18.95,124,81.05,153,99.35,1,0.65,154
1,VIC,200,Quarry Hill,314,51.73,293,48.27,607,98.86,7,1.14,614
1,VIC,328,Queenscliff,321,62.7,191,37.3,512,99.22,4,0.78,516
1,VIC,224,Rainbow,79,19.46,327,80.54,406,98.31,7,1.69,413
1,VIC,200,Raywood,50,22.12,176,77.88,226,98.26,4,1.74,230
1,VIC,224,Red Cliffs,257,21.85,919,78.15,1176,98.74,15,1.26,1191
1,VIC,211,Red Hill,438,65.96,226,34.04,664,98.81,8,1.19,672
1,VIC,198,Redan,414,50.86,400,49.14,814,98.55,12,1.45,826
1,VIC,200,Redesdale,132,45.36,159,54.64,291,99.32,2,0.68,293
1,VIC,320,Regent,1169,67.38,566,32.62,1735,98.75,22,1.25,1757
1,VIC,320,Regent West,347,58.42,247,41.58,594,98.51,9,1.49,603
1,VIC,213,Remote Mobile Team 1,54,30.68,122,69.32,176,99.44,1,0.56,177
1,VIC,220,Research,1084,55.85,857,44.15,1941,99.13,17,0.87,1958
1,VIC,320,Reservoir,877,61.29,554,38.71,1431,98.69,19,1.31,1450
1,VIC,320,Reservoir Central,645,53.71,556,46.29,1201,98.85,14,1.15,1215
1,VIC,320,Reservoir East,457,56,359,44,816,98.43,13,1.57,829
1,VIC,320,Reservoir North,1066,59.55,724,40.45,1790,98.46,28,1.54,1818
1,VIC,320,Reservoir North East,605,59.78,407,40.22,1012,99.02,10,0.98,1022
1,VIC,320,Reservoir South,490,65.07,263,34.93,753,99.08,7,0.92,760
1,VIC,320,Reservoir Upper,777,61.52,486,38.48,1263,98.67,17,1.33,1280
1,VIC,320,Reservoir West,776,62.08,474,37.92,1250,98.89,14,1.11,1264
1,VIC,323,Rhyll,129,49.81,130,50.19,259,99.62,1,0.38,260
1,VIC,228,Richmond,1518,74.59,517,25.41,2035,99.07,19,0.93,2054
1,VIC,228,Richmond Central,1498,75.66,482,24.34,1980,99.15,17,0.85,1997
1,VIC,228,Richmond South,1014,75.33,332,24.67,1346,98.83,16,1.17,1362
1,VIC,228,Richmond West,753,66.58,378,33.42,1131,98.61,16,1.39,1147
1,VIC,226,Riddell,727,46.34,842,53.66,1569,98.74,20,1.26,1589
1,VIC,209,Ringwood,536,55.72,426,44.28,962,99.18,8,0.82,970
1,VIC,204,Ringwood CASEY PPVC,288,50.26,285,49.74,573,99.13,5,0.87,578
1,VIC,209,Ringwood Central,549,55.74,436,44.26,985,99.39,6,0.61,991
1,VIC,209,Ringwood DEAKIN PPVC,6214,45.33,7495,54.67,13709,99.2,110,0.8,13819
1,VIC,209,Ringwood East,490,57.24,366,42.76,856,99.07,8,0.93,864
1,VIC,209,Ringwood East Central,955,64.09,535,35.91,1490,99.07,14,0.93,1504
1,VIC,209,Ringwood Heights,637,61.84,393,38.16,1030,98.85,12,1.15,1042
1,VIC,229,Ringwood MENZIES PPVC,1106,47.41,1227,52.59,2333,99.32,16,0.68,2349
1,VIC,209,Ringwood North (Deakin),814,49.21,840,50.79,1654,98.51,25,1.49,1679
1,VIC,229,Ringwood North (Menzies),121,44.98,148,55.02,269,99.26,2,0.74,271
1,VIC,209,Ringwood Upper,779,51.86,723,48.14,1502,98.95,16,1.05,1518
1,VIC,322,Ripponlea,1073,80.62,258,19.38,1331,99.33,9,0.67,1340
1,VIC,224,Robinvale,230,23.42,752,76.58,982,99.7,3,0.3,985
1,VIC,324,Rochester,225,22.66,768,77.34,993,98.51,15,1.49,1008
1,VIC,309,Rockbank,656,51.37,621,48.63,1277,98.99,13,1.01,1290
1,VIC,198,Rokewood,31,17.71,144,82.29,175,96.69,6,3.31,181
1,VIC,226,Romsey,784,37.21,1323,62.79,2107,99.01,21,0.99,2128
1,VIC,220,Rosanna,814,66.83,404,33.17,1218,99.19,10,0.81,1228
1,VIC,220,Rosanna Central,490,69.7,213,30.3,703,99.15,6,0.85,709
1,VIC,220,Rosanna East,1552,63.5,892,36.5,2444,98.87,28,1.13,2472
1,VIC,211,Rosebud East,622,47.34,692,52.66,1314,98.35,22,1.65,1336
1,VIC,211,Rosebud PPVC,7881,39,12327,61,20208,99.06,191,0.94,20399
1,VIC,211,Rosebud South,559,51.9,518,48.1,1077,98.72,14,1.28,1091
1,VIC,211,Rosebud West,494,47.05,556,52.95,1050,98.31,18,1.69,1068
1,VIC,213,Rosedale,161,20.61,620,79.39,781,98.86,9,1.14,790
1,VIC,198,Ross Creek,196,33,398,67,594,99,6,1,600
1,VIC,197,Rowville,609,42.65,819,57.35,1428,98.55,21,1.45,1449
1,VIC,197,Rowville ASTON PPVC,2600,34.03,5041,65.97,7641,98.94,82,1.06,7723
1,VIC,201,Rowville BRUCE PPVC,228,30.24,526,69.76,754,99.6,3,0.4,757
1,VIC,204,Rowville CASEY PPVC,238,45.68,283,54.32,521,99.24,4,0.76,525
1,VIC,197,Rowville Central,524,46.33,607,53.67,1131,97.92,24,2.08,1155
1,VIC,197,Rowville East,125,37.31,210,62.69,335,99.11,3,0.89,338
1,VIC,197,Rowville Heights,950,42.95,1262,57.05,2212,98.79,27,1.21,2239
1,VIC,197,Rowville North,348,43.28,456,56.72,804,98.29,14,1.71,818
1,VIC,197,Rowville North East,769,43.08,1016,56.92,1785,99.17,15,0.83,1800
1,VIC,197,Rowville South,944,41.28,1343,58.72,2287,98.75,29,1.25,2316
1,VIC,203,Roxburgh Homestead,835,45.31,1008,54.69,1843,97.36,50,2.64,1893
1,VIC,203,Roxburgh Park,331,45.84,391,54.16,722,91.74,65,8.26,787
1,VIC,203,Roxburgh Park North,603,37.48,1006,62.52,1609,96.93,51,3.07,1660
1,VIC,203,Roxburgh Rise,685,42.15,940,57.85,1625,96.61,57,3.39,1682
1,VIC,218,Ruffy,55,43.31,72,56.69,127,99.22,1,0.78,128
1,VIC,224,Rupanyup,76,27.74,198,72.26,274,99.64,1,0.36,275
1,VIC,324,Rushworth,140,20.09,557,79.91,697,99.29,5,0.71,702
1,VIC,218,Rutherglen,336,33.5,667,66.5,1003,99.21,8,0.79,1011
1,VIC,211,Rye,673,51.37,637,48.63,1310,98.72,17,1.28,1327
1,VIC,200,Sailors Gully,106,36.68,183,63.32,289,98.97,3,1.03,292
1,VIC,213,Sale,579,32.27,1215,67.73,1794,98.57,26,1.43,1820
1,VIC,213,Sale East,359,34.85,671,65.15,1030,99.32,7,0.68,1037
1,VIC,213,Sale North,92,33.33,184,66.67,276,98.92,3,1.08,279
1,VIC,213,Sale PPVC,2922,23.43,9551,76.57,12473,99.26,93,0.74,12566
1,VIC,323,San Remo,240,44.53,299,55.47,539,98.18,10,1.82,549
1,VIC,212,Sanctuary Lakes,888,56.96,671,43.04,1559,98.86,18,1.14,1577
1,VIC,217,Sandown Park,628,57.04,473,42.96,1101,97.95,23,2.05,1124
1,VIC,322,Sandridge,445,58.17,320,41.83,765,98.71,10,1.29,775
1,VIC,214,Sandringham,692,63.84,392,36.16,1084,99.45,6,0.55,1090
1,VIC,214,Sandringham North,980,67.49,472,32.51,1452,99.05,14,0.95,1466
1,VIC,204,Sassafras,357,68.52,164,31.48,521,98.86,6,1.14,527
1,VIC,197,Scoresby,907,49.21,936,50.79,1843,98.98,19,1.02,1862
1,VIC,197,Scoresby ASTON PPVC,4761,38.05,7752,61.95,12513,99.07,118,0.93,12631
1,VIC,209,Scoresby DEAKIN PPVC,450,43.14,593,56.86,1043,98.96,11,1.04,1054
1,VIC,233,Scotts Creek,53,22.65,181,77.35,234,99.57,1,0.43,235
1,VIC,224,Sea Lake,44,11.2,349,88.8,393,99.24,3,0.76,396
1,VIC,212,Seabrook,799,49.57,813,50.43,1612,98.96,17,1.04,1629
1,VIC,210,Seaford,757,56.16,591,43.84,1348,98.54,20,1.46,1368
1,VIC,210,Seaford East,761,48.13,820,51.87,1581,98.69,21,1.31,1602
1,VIC,210,Seaford North,604,56.71,461,43.29,1065,99.07,10,0.93,1075
1,VIC,210,Seaford South,718,59.54,488,40.46,1206,99.1,11,0.9,1217
1,VIC,212,Seaholme,586,53.86,502,46.14,1088,98.64,15,1.36,1103
1,VIC,213,Seaspray,63,41.45,89,58.55,152,100,0,0,152
1,VIC,198,Sebastopol,559,37.98,913,62.02,1472,98.13,28,1.87,1500
1,VIC,198,Sebastopol North,652,37.19,1101,62.81,1753,98.37,29,1.63,1782
1,VIC,198,Sebastopol PPVC,4382,39.13,6816,60.87,11198,99.11,100,0.89,11298
1,VIC,321,Seddon,1297,80.26,319,19.74,1616,99.26,12,0.74,1628
1,VIC,204,Selby,449,66.42,227,33.58,676,98.98,7,1.02,683
1,VIC,224,Serpentine,40,25.64,116,74.36,156,100,0,0,156
1,VIC,204,Seville,426,38.21,689,61.79,1115,98.41,18,1.59,1133
1,VIC,324,Seymour,276,30.56,627,69.44,903,99.23,7,0.77,910
1,VIC,218,Seymour INDI PPVC,246,28.54,616,71.46,862,99.19,7,0.81,869
1,VIC,226,Seymour MCEWEN PPVC,96,21.57,349,78.43,445,99.78,1,0.22,446
1,VIC,324,Seymour NICHOLLS PPVC,1567,24.95,4713,75.05,6280,99.07,59,0.93,6339
1,VIC,324,Shepparton Central,391,37.78,644,62.22,1035,99.14,9,0.86,1044
1,VIC,324,Shepparton City PPVC,577,24.85,1745,75.15,2322,99.1,21,0.9,2343
1,VIC,324,Shepparton East,88,19.21,370,80.79,458,98.28,8,1.72,466
1,VIC,324,Shepparton North,443,29.95,1036,70.05,1479,98.73,19,1.27,1498
1,VIC,324,Shepparton PPVC,4528,25.06,13538,74.94,18066,99.15,155,0.85,18221
1,VIC,324,Shepparton South,415,34.04,804,65.96,1219,98.23,22,1.77,1241
1,VIC,211,Shoreham,231,73.8,82,26.2,313,98.74,4,1.26,317
1,VIC,204,Silvan,224,34.62,423,65.38,647,98.78,8,1.22,655
1,VIC,233,Simpson,49,15.46,268,84.54,317,100,0,0,317
1,VIC,233,Skipton,107,29.32,258,70.68,365,99.46,2,0.54,367
1,VIC,210,Skye,475,41.89,659,58.11,1134,99.04,11,0.96,1145
1,VIC,198,Smythesdale,251,32.98,510,67.02,761,98.45,12,1.55,773
1,VIC,233,Snake Valley,166,33.07,336,66.93,502,99.6,2,0.4,504
1,VIC,211,Somers,295,71.43,118,28.57,413,98.33,7,1.67,420
1,VIC,211,Somerville,253,40.87,366,59.13,619,98.72,8,1.28,627
1,VIC,211,Somerville East,485,41.14,694,58.86,1179,98.41,19,1.59,1198
1,VIC,211,Somerville West,671,40.89,970,59.11,1641,98.38,27,1.62,1668
1,VIC,211,Sorrento,311,48.44,331,51.56,642,99.69,2,0.31,644
1,VIC,212,South Kingsville,619,68.47,285,31.53,904,99.12,8,0.88,912
1,VIC,322,South Melbourne,1019,69.23,453,30.77,1472,98.79,18,1.21,1490
1,VIC,232,South Morang,689,41.04,990,58.96,1679,98.36,28,1.64,1707
1,VIC,232,South Morang Central,1139,40.04,1706,59.96,2845,98.44,45,1.56,2890
1,VIC,232,South Morang Lakes,331,44.55,412,55.45,743,98.54,11,1.46,754
1,VIC,215,South Yarra,734,74.44,252,25.56,986,99.7,3,0.3,989
1,VIC,215,South Yarra Central,826,73.49,298,26.51,1124,99.21,9,0.79,1133
1,VIC,215,South Yarra South,864,65.01,465,34.99,1329,98.66,18,1.34,1347
1,VIC,322,Southbank,1225,65.58,643,34.42,1868,99.1,17,0.9,1885
1,VIC,322,Southbank North,817,68.77,371,31.23,1188,98.92,13,1.08,1201
1,VIC,233,Special Hospital Team 1,129,34.49,245,65.51,374,98.42,6,1.58,380
1,VIC,218,Special Hospital Team 1,174,45.67,207,54.33,381,98.7,5,1.3,386
1,VIC,200,Special Hospital Team 1,93,42.47,126,57.53,219,97.33,6,2.67,225
1,VIC,219,Special Hospital Team 1,96,64,54,36,150,97.4,4,2.6,154
1,VIC,224,Special Hospital Team 1,60,29.7,142,70.3,202,99.02,2,0.98,204
1,VIC,323,Special Hospital Team 1,77,48.43,82,51.57,159,92.98,12,7.02,171
1,VIC,197,Special Hospital Team 1,133,56.36,103,43.64,236,98.74,3,1.26,239
1,VIC,220,Special Hospital Team 1,38,55.88,30,44.12,68,100,0,0,68
1,VIC,328,Special Hospital Team 1,131,50.58,128,49.42,259,98.11,5,1.89,264
1,VIC,208,Special Hospital Team 1,103,52.02,95,47.98,198,87.22,29,12.78,227
1,VIC,225,Special Hospital Team 1,98,52.97,87,47.03,185,96.35,7,3.65,192
1,VIC,203,Special Hospital Team 1,65,61.32,41,38.68,106,94.64,6,5.36,112
1,VIC,222,Special Hospital Team 1,135,54.66,112,45.34,247,98.02,5,1.98,252
1,VIC,216,Special Hospital Team 1,121,49.79,122,50.21,243,98.38,4,1.62,247
1,VIC,210,Special Hospital Team 1,50,64.94,27,35.06,77,100,0,0,77
1,VIC,211,Special Hospital Team 1,126,58.06,91,41.94,217,98.64,3,1.36,220
1,VIC,232,Special Hospital Team 1,39,58.21,28,41.79,67,90.54,7,9.46,74
1,VIC,234,Special Hospital Team 1,54,50,54,50,108,99.08,1,0.92,109
1,VIC,321,Special Hospital Team 1,56,66.67,28,33.33,84,98.82,1,1.18,85
1,VIC,309,Special Hospital Team 1,61,50.83,59,49.17,120,99.17,1,0.83,121
1,VIC,326,Special Hospital Team 1,85,42.71,114,57.29,199,93.87,13,6.13,212
1,VIC,212,Special Hospital Team 1,109,58.6,77,41.4,186,97.89,4,2.11,190
1,VIC,198,Special Hospital Team 1,149,51.56,140,48.44,289,96.66,10,3.34,299
1,VIC,205,Special Hospital Team 1,91,67.41,44,32.59,135,94.41,8,5.59,143
1,VIC,204,Special Hospital Team 1,87,48.07,94,51.93,181,95.77,8,4.23,189
1,VIC,209,Special Hospital Team 1,54,48.65,57,51.35,111,98.23,2,1.77,113
1,VIC,229,Special Hospital Team 1,77,75.49,25,24.51,102,98.08,2,1.92,104
1,VIC,324,Special Hospital Team 1,153,45.27,185,54.73,338,98.83,4,1.17,342
1,VIC,214,Special Hospital Team 1,116,58.59,82,41.41,198,98.02,4,1.98,202
1,VIC,217,Special Hospital Team 1,92,61.33,58,38.67,150,95.54,7,4.46,157
1,VIC,228,Special Hospital Team 1,26,83.87,5,16.13,31,100,0,0,31
1,VIC,320,Special Hospital Team 1,53,63.86,30,36.14,83,98.81,1,1.19,84
1,VIC,322,Special Hospital Team 1,79,64.23,44,35.77,123,99.19,1,0.81,124
1,VIC,223,Special Hospital Team 1,100,51.55,94,48.45,194,99.49,1,0.51,195
1,VIC,201,Special Hospital Team 1,72,56.69,55,43.31,127,99.22,1,0.78,128
1,VIC,221,Special Hospital Team 1,144,63.44,83,36.56,227,99.56,1,0.44,228
1,VIC,213,Special Hospital Team 1,72,35.12,133,64.88,205,97.62,5,2.38,210
1,VIC,215,Special Hospital Team 1,67,61.47,42,38.53,109,98.2,2,1.8,111
1,VIC,226,Special Hospital Team 1,54,53.47,47,46.53,101,99.02,1,0.98,102
1,VIC,224,Special Hospital Team 2,28,27.45,74,72.55,102,99.03,1,0.97,103
1,VIC,198,Special Hospital Team 2,77,45.83,91,54.17,168,99.41,1,0.59,169
1,VIC,233,Special Hospital Team 2,16,27.59,42,72.41,58,95.08,3,4.92,61
1,VIC,218,Special Hospital Team 2,97,35.53,176,64.47,273,99.27,2,0.73,275
1,VIC,208,Special Hospital Team 2,106,51.71,99,48.29,205,98.56,3,1.44,208
1,VIC,200,Special Hospital Team 2,78,41.94,108,58.06,186,98.94,2,1.06,188
1,VIC,197,Special Hospital Team 2,135,51.53,127,48.47,262,98.87,3,1.13,265
1,VIC,323,Special Hospital Team 2,57,36.54,99,63.46,156,98.73,2,1.27,158
1,VIC,326,Special Hospital Team 2,69,47.92,75,52.08,144,100,0,0,144
1,VIC,209,Special Hospital Team 2,69,58.47,49,41.53,118,97.52,3,2.48,121
1,VIC,328,Special Hospital Team 2,246,51.04,236,48.96,482,96.59,17,3.41,499
1,VIC,205,Special Hospital Team 2,63,49.22,65,50.78,128,96.24,5,3.76,133
1,VIC,229,Special Hospital Team 2,83,54.25,70,45.75,153,97.45,4,2.55,157
1,VIC,212,Special Hospital Team 2,77,55.8,61,44.2,138,99.28,1,0.72,139
1,VIC,222,Special Hospital Team 2,84,52.83,75,47.17,159,98.15,3,1.85,162
1,VIC,217,Special Hospital Team 2,79,58.52,56,41.48,135,94.41,8,5.59,143
1,VIC,219,Special Hospital Team 2,57,50.44,56,49.56,113,97.41,3,2.59,116
1,VIC,214,Special Hospital Team 2,58,50.88,56,49.12,114,94.21,7,5.79,121
1,VIC,201,Special Hospital Team 2,111,63.79,63,36.21,174,97.21,5,2.79,179
1,VIC,210,Special Hospital Team 2,98,56.32,76,43.68,174,100,0,0,174
1,VIC,211,Special Hospital Team 2,95,55.56,76,44.44,171,97.71,4,2.29,175
1,VIC,223,Special Hospital Team 2,54,51.92,50,48.08,104,96.3,4,3.7,108
1,VIC,220,Special Hospital Team 2,94,61.44,59,38.56,153,97.45,4,2.55,157
1,VIC,324,Special Hospital Team 2,83,35.93,148,64.07,231,99.57,1,0.43,232
1,VIC,215,Special Hospital Team 2,70,63.64,40,36.36,110,100,0,0,110
1,VIC,221,Special Hospital Team 2,166,68.88,75,31.12,241,94.14,15,5.86,256
1,VIC,213,Special Hospital Team 2,99,39.92,149,60.08,248,93.94,16,6.06,264
1,VIC,203,Special Hospital Team 2,21,70,9,30,30,96.77,1,3.23,31
1,VIC,321,Special Hospital Team 2,63,71.59,25,28.41,88,98.88,1,1.12,89
1,VIC,309,Special Hospital Team 2,20,46.51,23,53.49,43,97.73,1,2.27,44
1,VIC,225,Special Hospital Team 2,146,55.09,119,44.91,265,92.66,21,7.34,286
1,VIC,232,Special Hospital Team 2,51,37.78,84,62.22,135,87.66,19,12.34,154
1,VIC,234,Special Hospital Team 2,51,52.04,47,47.96,98,97.03,3,2.97,101
1,VIC,226,Special Hospital Team 2,60,61.22,38,38.78,98,97.03,3,2.97,101
1,VIC,228,Special Hospital Team 2,36,63.16,21,36.84,57,96.61,2,3.39,59
1,VIC,320,Special Hospital Team 2,38,58.46,27,41.54,65,98.48,1,1.52,66
1,VIC,322,Special Hospital Team 2,59,69.41,26,30.59,85,94.44,5,5.56,90
1,VIC,233,Special Hospital Team 3,33,19.88,133,80.12,166,99.4,1,0.6,167
1,VIC,218,Special Hospital Team 3,142,38.9,223,61.1,365,97.86,8,2.14,373
1,VIC,224,Special Hospital Team 3,80,36.7,138,63.3,218,97.76,5,2.24,223
1,VIC,205,Special Hospital Team 3,132,43.14,174,56.86,306,99.67,1,0.33,307
1,VIC,209,Special Hospital Team 3,107,58.47,76,41.53,183,95.31,9,4.69,192
1,VIC,229,Special Hospital Team 3,69,57.02,52,42.98,121,100,0,0,121
1,VIC,328,Special Hospital Team 3,181,52.92,161,47.08,342,97.99,7,2.01,349
1,VIC,208,Special Hospital Team 3,131,48.88,137,51.12,268,91.78,24,8.22,292
1,VIC,323,Special Hospital Team 3,64,51.2,61,48.8,125,95.42,6,4.58,131
1,VIC,198,Special Hospital Team 3,165,48.82,173,51.18,338,98.54,5,1.46,343
1,VIC,211,Special Hospital Team 3,115,43.89,147,56.11,262,94.58,15,5.42,277
1,VIC,220,Special Hospital Team 3,37,54.41,31,45.59,68,97.14,2,2.86,70
1,VIC,215,Special Hospital Team 3,61,64.21,34,35.79,95,91.35,9,8.65,104
1,VIC,221,Special Hospital Team 3,0,0,0,0,0,0,0,0,0
1,VIC,213,Special Hospital Team 3,116,33.82,227,66.18,343,99.13,3,0.87,346
1,VIC,324,Special Hospital Team 3,75,44.12,95,55.88,170,99.42,1,0.58,171
1,VIC,203,Special Hospital Team 3,5,38.46,8,61.54,13,100,0,0,13
1,VIC,321,Special Hospital Team 3,40,50,40,50,80,93.02,6,6.98,86
1,VIC,309,Special Hospital Team 3,8,53.33,7,46.67,15,100,0,0,15
1,VIC,225,Special Hospital Team 3,87,61.7,54,38.3,141,99.3,1,0.7,142
1,VIC,232,Special Hospital Team 3,55,48.67,58,51.33,113,95.76,5,4.24,118
1,VIC,234,Special Hospital Team 3,69,60.53,45,39.47,114,95,6,5,120
1,VIC,200,Special Hospital Team 3,138,49.11,143,50.89,281,98.6,4,1.4,285
1,VIC,210,Special Hospital Team 3,76,55.47,61,44.53,137,97.16,4,2.84,141
1,VIC,320,Special Hospital Team 3,31,56.36,24,43.64,55,100,0,0,55
1,VIC,322,Special Hospital Team 3,61,64.89,33,35.11,94,97.92,2,2.08,96
1,VIC,233,Special Hospital Team 4,116,48.54,123,51.46,239,99.58,1,0.42,240
1,VIC,224,Special Hospital Team 4,77,45.03,94,54.97,171,98.28,3,1.72,174
1,VIC,323,Special Hospital Team 4,72,54.14,61,45.86,133,100,0,0,133
1,VIC,211,Special Hospital Team 4,123,53.48,107,46.52,230,97.87,5,2.13,235
1,VIC,324,Special Hospital Team 4,72,25.99,205,74.01,277,97.88,6,2.12,283
1,VIC,200,Special Hospital Team 4,78,40,117,60,195,98.48,3,1.52,198
1,VIC,233,Special Hospital Team 5,49,44.95,60,55.05,109,89.34,13,10.66,122
1,VIC,224,Special Hospital Team 5,124,48.82,130,51.18,254,99.22,2,0.78,256
1,VIC,224,Special Hospital Team 6,84,29.47,201,70.53,285,99.3,2,0.7,287
1,VIC,212,Spotswood,451,69.49,198,30.51,649,98.93,7,1.07,656
1,VIC,200,Spring Gully,430,51.87,399,48.13,829,98.69,11,1.31,840
1,VIC,217,Spring Valley,431,51.13,412,48.87,843,98.6,12,1.4,855
1,VIC,218,Springhurst,36,22.5,124,77.5,160,98.77,2,1.23,162
1,VIC,217,Springvale,536,58.64,378,41.36,914,98.7,12,1.3,926
1,VIC,217,Springvale Central,383,52.32,349,47.68,732,98.39,12,1.61,744
1,VIC,217,Springvale Lower,564,48.66,595,51.34,1159,98.47,18,1.53,1177
1,VIC,217,Springvale South,678,55.94,534,44.06,1212,97.66,29,2.34,1241
1,VIC,217,Springvale South East,299,55.99,235,44.01,534,99.63,2,0.37,536
1,VIC,217,Springvale West,366,54.38,307,45.62,673,98.83,8,1.17,681
1,VIC,321,St Albans East,543,50.94,523,49.06,1066,98.7,14,1.3,1080
1,VIC,321,St Albans FRASER PPVC,5771,45.95,6789,54.05,12560,98.79,154,1.21,12714
1,VIC,309,St Albans GORTON PPVC,4151,36.63,7180,63.37,11331,98.82,135,1.18,11466
1,VIC,326,St Albans HAWKE PPVC,127,34.99,236,65.01,363,97.84,8,2.16,371
1,VIC,321,St Albans North,531,48.58,562,51.42,1093,99,11,1,1104
1,VIC,208,St Albans Park,703,35.61,1271,64.39,1974,99.3,14,0.7,1988
1,VIC,321,St Albans South,390,47.62,429,52.38,819,98.32,14,1.68,833
1,VIC,321,St Albans South East,502,54.45,420,45.55,922,98.93,10,1.07,932
1,VIC,321,St Albans West,204,48,221,52,425,97.7,10,2.3,435
1,VIC,226,St Andrews,372,55.44,299,44.56,671,98.1,13,1.9,684
1,VIC,211,St Andrews Beach,269,65.93,139,34.07,408,98.55,6,1.45,414
1,VIC,224,St Arnaud,279,20.91,1055,79.09,1334,98.67,18,1.33,1352
1,VIC,220,St Helena (Jagajaga),603,44.24,760,55.76,1363,98.91,15,1.09,1378
1,VIC,226,St Helena (McEwen),342,45.3,413,54.7,755,99.08,7,0.92,762
1,VIC,324,St James,19,15.57,103,84.43,122,99.19,1,0.81,123
1,VIC,322,St Kilda,1901,81.83,422,18.17,2323,98.98,24,1.02,2347
1,VIC,215,St Kilda North (Higgins),220,77.74,63,22.26,283,98.26,5,1.74,288
1,VIC,322,St Kilda North (Macnamara),1175,77,351,23,1526,99.03,15,0.97,1541
1,VIC,322,St Kilda Park,1546,76.76,468,23.24,2014,99.26,15,0.74,2029
1,VIC,322,St Kilda West,526,81.55,119,18.45,645,99.08,6,0.92,651
1,VIC,328,St Leonards,614,44.05,780,55.95,1394,98.87,16,1.13,1410
1,VIC,324,Stanhope,98,20.68,376,79.32,474,99.58,2,0.42,476
1,VIC,218,Stanley,147,59.04,102,40.96,249,99.2,2,0.8,251
1,VIC,224,Stawell,183,25.59,532,74.41,715,98.76,9,1.24,724
1,VIC,224,Stawell PPVC,565,21.8,2027,78.2,2592,99.2,21,0.8,2613
1,VIC,224,Stawell West,140,25.59,407,74.41,547,98.74,7,1.26,554
1,VIC,213,Stratford,256,28.04,657,71.96,913,99.02,9,0.98,922
1,VIC,218,Strathbogie,85,35.42,155,64.58,240,97.96,5,2.04,245
1,VIC,200,Strathdale,181,41.04,260,58.96,441,98.22,8,1.78,449
1,VIC,200,Strathfieldsaye,770,43.85,986,56.15,1756,99.1,16,0.9,1772
1,VIC,324,Strathmerton,70,16.75,348,83.25,418,99.29,3,0.71,421
1,VIC,225,Strathmore,895,52.77,801,47.23,1696,99.3,12,0.7,1708
1,VIC,225,Strathmore North,461,53.29,404,46.71,865,99.43,5,0.57,870
1,VIC,326,Strathtulloh,664,51.71,620,48.29,1284,99,13,1,1297
1,VIC,326,Sunbury,735,43.01,974,56.99,1709,98.67,23,1.33,1732
1,VIC,326,Sunbury East,490,37.29,824,62.71,1314,99.02,13,0.98,1327
1,VIC,326,Sunbury HAWKE PPVC,5038,33.45,10023,66.55,15061,99.09,138,0.91,15199
1,VIC,326,Sunbury Heights,660,40.32,977,59.68,1637,98.26,29,1.74,1666
1,VIC,226,Sunbury MCEWEN PPVC,2106,36.22,3708,63.78,5814,99.28,42,0.72,5856
1,VIC,326,Sunbury North,474,50.86,458,49.14,932,99.47,5,0.53,937
1,VIC,326,Sunbury South,187,43.29,245,56.71,432,99.54,2,0.46,434
1,VIC,326,Sunbury West,650,45.2,788,54.8,1438,98.97,15,1.03,1453
1,VIC,321,Sunshine,473,51.08,453,48.92,926,99.14,8,0.86,934
1,VIC,321,Sunshine East,717,59.55,487,40.45,1204,98.53,18,1.47,1222
1,VIC,321,Sunshine FRASER PPVC,7130,49.71,7214,50.29,14344,98.97,149,1.03,14493
1,VIC,309,Sunshine GORTON PPVC,858,44.99,1049,55.01,1907,98.86,22,1.14,1929
1,VIC,321,Sunshine North,534,62.24,324,37.76,858,99.08,8,0.92,866
1,VIC,321,Sunshine North West,423,50.84,409,49.16,832,98.35,14,1.65,846
1,VIC,321,Sunshine West,678,49.31,697,50.69,1375,98.57,20,1.43,1395
1,VIC,321,Sunshine West Central,768,60.14,509,39.86,1277,98,26,2,1303
1,VIC,321,Sunshine West South,516,52.49,467,47.51,983,98.01,20,1.99,1003
1,VIC,221,Surrey Hills,1026,67.15,502,32.85,1528,99.16,13,0.84,1541
1,VIC,221,Surrey Hills North,950,64.23,529,35.77,1479,99.4,9,0.6,1488
1,VIC,221,Surrey Hills West,1150,63.85,651,36.15,1801,98.9,20,1.1,1821
1,VIC,224,Swan Hill,217,25.26,642,74.74,859,98.96,9,1.04,868
1,VIC,224,Swan Hill PPVC,1186,15.74,6349,84.26,7535,99.52,36,0.48,7571
1,VIC,224,Swan Hill West,154,23.23,509,76.77,663,98.37,11,1.63,674
1,VIC,218,Swanpool,58,28.86,143,71.14,201,99.01,2,0.99,203
1,VIC,213,Swifts Creek,76,30.65,172,69.35,248,98.8,3,1.2,251
1,VIC,309,Sydenham Central,356,42.03,491,57.97,847,98.72,11,1.28,858
1,VIC,309,Sydenham West,933,39.17,1449,60.83,2382,98.47,37,1.53,2419
1,VIC,205,Syndal South,673,55.03,550,44.97,1223,99.67,4,0.33,1227
1,VIC,218,Taggerty,109,36.58,189,63.42,298,98.35,5,1.65,303
1,VIC,224,Talbot,87,30.31,200,69.69,287,99.31,2,0.69,289
1,VIC,218,Tallangatta,209,30.65,473,69.35,682,99.56,3,0.44,685
1,VIC,324,Tallarook,49,31.21,108,68.79,157,98.13,3,1.88,160
1,VIC,218,Tangambalanga,160,25.48,468,74.52,628,99.52,3,0.48,631
1,VIC,200,Taradale,213,66.36,108,33.64,321,98.47,5,1.53,326
1,VIC,224,Tarnagulla,40,25,120,75,160,99.38,1,0.62,161
1,VIC,222,Tarneit,1063,52.7,954,47.3,2017,99.21,16,0.79,2033
1,VIC,222,Tarneit Central,1265,62.87,747,37.13,2012,99.36,13,0.64,2025
1,VIC,222,Tarneit West,1764,64.78,959,35.22,2723,99.27,20,0.73,2743
1,VIC,218,Tarrawingee,99,38.08,161,61.92,260,99.24,2,0.76,262
1,VIC,233,Tarrington,48,26.37,134,73.63,182,100,0,0,182
1,VIC,323,Tarwin Lower,304,49.92,305,50.08,609,99.02,6,0.98,615
1,VIC,218,Tatong,30,24.79,91,75.21,121,97.58,3,2.42,124
1,VIC,324,Tatura,399,25.78,1149,74.22,1548,99.29,11,0.71,1559
1,VIC,309,Taylors Hill,757,41.48,1068,58.52,1825,98.17,34,1.83,1859
1,VIC,309,Taylors Lakes,261,34.89,487,65.11,748,98.81,9,1.19,757
1,VIC,309,Taylors Lakes Central,1078,32.79,2210,67.21,3288,98.44,52,1.56,3340
1,VIC,309,Taylors Lakes North,733,32.08,1552,67.92,2285,98.92,25,1.08,2310
1,VIC,204,Tecoma,1155,64.42,638,35.58,1793,98.46,28,1.54,1821
1,VIC,198,Teesdale,381,37.32,640,62.68,1021,98.27,18,1.73,1039
1,VIC,229,Templestowe,430,43.88,550,56.12,980,98.89,11,1.11,991
1,VIC,229,Templestowe East,566,41.5,798,58.5,1364,98.48,21,1.52,1385
1,VIC,229,Templestowe Heights,1006,46.83,1142,53.17,2148,98.99,22,1.01,2170
1,VIC,229,Templestowe Lower,419,46.5,482,53.5,901,98.26,16,1.74,917
1,VIC,229,Templestowe Lower PPVC,2911,39.81,4402,60.19,7313,99,74,1,7387
1,VIC,229,Templestowe Park,527,41.76,735,58.24,1262,98.83,15,1.17,1277
1,VIC,229,Templestowe Valley,424,47.43,470,52.57,894,99.44,5,0.56,899
1,VIC,229,Templestowe West,110,46.22,128,53.78,238,100,0,0,238
1,VIC,233,Terang,255,22.95,856,77.05,1111,99.2,9,0.8,1120
1,VIC,197,The Basin,703,53.18,619,46.82,1322,98.36,22,1.64,1344
1,VIC,205,The Glen,828,51.14,791,48.86,1619,98.84,19,1.16,1638
1,VIC,222,The Grange,783,44.34,983,55.66,1766,98.49,27,1.51,1793
1,VIC,204,The Patch,403,69.72,175,30.28,578,99.14,5,0.86,583
1,VIC,229,The Pines,524,42.78,701,57.22,1225,99.19,10,0.81,1235
1,VIC,222,Thomas Chirnside,458,47.56,505,52.44,963,98.97,10,1.03,973
1,VIC,232,Thomastown,334,49.26,344,50.74,678,97.98,14,2.02,692
1,VIC,232,Thomastown East,377,45.7,448,54.3,825,97.63,20,2.37,845
1,VIC,232,Thomastown Heights,247,37.09,419,62.91,666,97.94,14,2.06,680
1,VIC,232,Thomastown Meadows,355,29.63,843,70.37,1198,97.64,29,2.36,1227
1,VIC,232,Thomastown North,200,50.89,193,49.11,393,99.75,1,0.25,394
1,VIC,232,Thomastown West,657,36.87,1125,63.13,1782,98.4,29,1.6,1811
1,VIC,208,Thomson,542,46.05,635,53.95,1177,98.82,14,1.18,1191
1,VIC,320,Thornbury,1377,81.48,313,18.52,1690,99.18,14,0.82,1704
1,VIC,320,Thornbury East,1434,71.38,575,28.62,2009,98.97,21,1.03,2030
1,VIC,320,Thornbury South,980,78.84,263,21.16,1243,99.12,11,0.88,1254
1,VIC,218,Thornton,64,28.44,161,71.56,225,99.56,1,0.44,226
1,VIC,323,Thorpdale,69,22.92,232,77.08,301,99.34,2,0.66,303
1,VIC,233,Timboon,170,24.53,523,75.47,693,98.72,9,1.28,702
1,VIC,224,Timor,22,21.36,81,78.64,103,99.04,1,0.96,104
1,VIC,209,Tinternvale,762,53.32,667,46.68,1429,99.1,13,0.9,1442
1,VIC,218,Tolmie,35,38.46,56,61.54,91,100,0,0,91
1,VIC,324,Tongala,110,16.77,546,83.23,656,98.94,7,1.06,663
1,VIC,324,Tooborac,37,28.46,93,71.54,130,98.48,2,1.52,132
1,VIC,324,Toolamba,87,31.52,189,68.48,276,99.28,2,0.72,278
1,VIC,218,Toolangi,93,40.97,134,59.03,227,99.13,2,0.87,229
1,VIC,326,Toolern Vale,130,28.2,331,71.8,461,98.29,8,1.71,469
1,VIC,213,Toongabbie,83,19.04,353,80.96,436,99.54,2,0.46,438
1,VIC,323,Toora,191,37.3,321,62.7,512,97.9,11,2.1,523
1,VIC,216,Tooradin,194,26.65,534,73.35,728,99.32,5,0.68,733
1,VIC,215,Toorak,549,49.02,571,50.98,1120,99.38,7,0.62,1127
1,VIC,215,Toorak Central,813,59.34,557,40.66,1370,98.85,16,1.15,1386
1,VIC,215,Toorak West,258,50.29,255,49.71,513,99.23,4,0.77,517
1,VIC,213,Toorloo Arm,114,47.3,127,52.7,241,99.18,2,0.82,243
1,VIC,211,Tootgarook,349,50.95,336,49.05,685,98.42,11,1.58,696
1,VIC,328,Torquay,993,64.06,557,35.94,1550,98.92,17,1.08,1567
1,VIC,328,Torquay CORANGAMITE PPVC,9091,51.37,8607,48.63,17698,99.03,173,0.97,17871
1,VIC,208,Torquay CORIO PPVC,854,48.63,902,51.37,1756,99.15,15,0.85,1771
1,VIC,328,Torquay East,392,66.55,197,33.45,589,98.33,10,1.67,599
1,VIC,328,Torquay North,1014,69.12,453,30.88,1467,98.99,15,1.01,1482
1,VIC,233,Torquay WANNON PPVC,721,61.1,459,38.9,1180,99.24,9,0.76,1189
1,VIC,324,Torrumbarry,17,15.32,94,84.68,111,99.11,1,0.89,112
1,VIC,323,Trafalgar,447,32.11,945,67.89,1392,98.79,17,1.21,1409
1,VIC,213,Traralgon,821,36.85,1407,63.15,2228,98.8,27,1.2,2255
1,VIC,213,Traralgon East,438,31.67,945,68.33,1383,99,14,1,1397
1,VIC,213,Traralgon North,392,35.38,716,64.62,1108,98.75,14,1.25,1122
1,VIC,213,Traralgon PPVC,3218,24.23,10064,75.77,13282,99.3,93,0.7,13375
1,VIC,213,Traralgon South,109,37.46,182,62.54,291,98.31,5,1.69,296
1,VIC,213,Traralgon West,327,39.26,506,60.74,833,98.46,13,1.54,846
1,VIC,198,Trentham,541,61.76,335,38.24,876,99.55,4,0.45,880
1,VIC,212,Truganina,1191,65.48,628,34.52,1819,99.13,16,0.87,1835
1,VIC,212,Truganina East,635,63.56,364,36.44,999,98.91,11,1.09,1010
1,VIC,212,Truganina GELLIBRAND PPVC,3257,58.93,2270,41.07,5527,99.46,30,0.54,5557
1,VIC,309,Truganina GORTON PPVC,167,44.06,212,55.94,379,99.21,3,0.79,382
1,VIC,222,Truganina LALOR PPVC,3166,45.77,3751,54.23,6917,99.31,48,0.69,6965
1,VIC,212,Truganina South (Gellibrand),96,57.14,72,42.86,168,98.25,3,1.75,171
1,VIC,222,Truganina South (Lalor),1022,57.9,743,42.1,1765,98.6,25,1.4,1790
1,VIC,225,Tullamarine,648,39.06,1011,60.94,1659,98.69,22,1.31,1681
1,VIC,324,Tungamah,46,26.29,129,73.71,175,98.31,3,1.69,178
1,VIC,211,Tyabb,357,37.42,597,62.58,954,98.96,10,1.04,964
1,VIC,213,Tyers,73,24.83,221,75.17,294,99.32,2,0.68,296
1,VIC,200,Tylden,169,42.57,228,57.43,397,100,0,0,397
1,VIC,223,Tynong,138,27.54,363,72.46,501,99.4,3,0.6,504
1,VIC,324,Undera,34,16.27,175,83.73,209,98.58,3,1.42,212
1,VIC,224,Underbool,10,7.46,124,92.54,134,99.26,1,0.74,135
1,VIC,197,Upper Ferntree Gully (Aston),460,56.65,352,43.35,812,98.66,11,1.34,823
1,VIC,204,Upper Ferntree Gully (Casey),246,60.29,162,39.71,408,98.79,5,1.21,413
1,VIC,204,Upwey,683,61.09,435,38.91,1118,98.42,18,1.58,1136
1,VIC,204,Upwey South,445,64.87,241,35.13,686,99.42,4,0.58,690
1,VIC,217,Valkstone,467,52.77,418,47.23,885,98.99,9,1.01,894
1,VIC,209,Vermont Central,790,54,673,46,1463,99.39,9,0.61,1472
1,VIC,209,Vermont East,563,51.99,520,48.01,1083,99.09,10,0.91,1093
1,VIC,209,Vermont North,522,52.1,480,47.9,1002,99.11,9,0.89,1011
1,VIC,209,Vermont South,734,47.76,803,52.24,1537,99.03,15,0.97,1552
1,VIC,209,Vermont South Lower,364,46.13,425,53.87,789,99.5,4,0.5,793
1,VIC,218,Violet Town,209,37.59,347,62.41,556,99.29,4,0.71,560
1,VIC,218,Wahgunyah,165,28.45,415,71.55,580,98.98,6,1.02,586
1,VIC,226,Wallan Central,318,35.14,587,64.86,905,99.02,9,0.98,914
1,VIC,226,Wallan South,497,36.12,879,63.88,1376,98.5,21,1.5,1397
1,VIC,226,Wallan Wallan,651,37.14,1102,62.86,1753,98.65,24,1.35,1777
1,VIC,328,Wallington,327,49.77,330,50.23,657,98.65,9,1.35,666
1,VIC,218,Walwa,46,24.21,144,75.79,190,98.45,3,1.55,193
1,VIC,218,Wandiligong,69,60.53,45,39.47,114,98.28,2,1.72,116
1,VIC,204,Wandin Yallock,391,33.82,765,66.18,1156,98.72,15,1.28,1171
1,VIC,226,Wandong,205,31.3,450,68.7,655,98.79,8,1.21,663
1,VIC,226,Wandong PPVC,2091,26.78,5718,73.22,7809,99.34,52,0.66,7861
1,VIC,324,Wanganui,293,35.22,539,64.78,832,98.46,13,1.54,845
1,VIC,218,Wangaratta,541,39.46,830,60.54,1371,98.78,17,1.22,1388
1,VIC,218,Wangaratta PPVC,4433,29.77,10459,70.23,14892,99.18,123,0.82,15015
1,VIC,218,Wangaratta Voting Day PPVC,0,0,0,0,0,0,0,0,0
1,VIC,197,Wantirna,726,48.76,763,51.24,1489,98.48,23,1.52,1512
1,VIC,197,Wantirna Central,787,44.24,992,55.76,1779,98.72,23,1.28,1802
1,VIC,197,Wantirna East,523,45.64,623,54.36,1146,98.62,16,1.38,1162
1,VIC,197,Wantirna South,482,44.92,591,55.08,1073,99.26,8,0.74,1081
1,VIC,197,Wantirna South West,531,45.11,646,54.89,1177,98.91,13,1.09,1190
1,VIC,197,Wantirna West,452,41.77,630,58.23,1082,99.18,9,0.82,1091
1,VIC,204,Warburton,347,55.52,278,44.48,625,98.74,8,1.26,633
1,VIC,204,Warburton East,205,44.28,258,55.72,463,98.09,9,1.91,472
1,VIC,216,Warneet,239,30.29,550,69.71,789,99.62,3,0.38,792
1,VIC,224,Warracknabeal,242,20.84,919,79.16,1161,98.89,13,1.11,1174
1,VIC,323,Warragul,553,42.21,757,57.79,1310,98.64,18,1.36,1328
1,VIC,323,Warragul East,306,37.41,512,62.59,818,98.67,11,1.33,829
1,VIC,223,Warragul LA TROBE PPVC,156,23.78,500,76.22,656,99.54,3,0.46,659
1,VIC,323,Warragul MONASH PPVC,4806,28.09,12303,71.91,17109,99.15,146,0.85,17255
1,VIC,323,Warragul North,439,39.91,661,60.09,1100,98.92,12,1.08,1112
1,VIC,229,Warrandyte,830,61.85,512,38.15,1342,99.41,8,0.59,1350
1,VIC,209,Warranwood (Deakin),904,49.05,939,50.95,1843,98.93,20,1.07,1863
1,VIC,229,Warranwood (Menzies),132,54.32,111,45.68,243,99.59,1,0.41,244
1,VIC,198,Warrenheip,272,37.47,454,62.53,726,99.59,3,0.41,729
1,VIC,233,Warrion,23,20,92,80,115,97.46,3,2.54,118
1,VIC,233,Warrnambool,345,50,345,50,690,99.28,5,0.72,695
1,VIC,233,Warrnambool Central,846,45.05,1032,54.95,1878,98.74,24,1.26,1902
1,VIC,233,Warrnambool East,284,39.66,432,60.34,716,98.9,8,1.1,724
1,VIC,233,Warrnambool North Central,752,41.09,1078,58.91,1830,98.97,19,1.03,1849
1,VIC,233,Warrnambool PPVC,6117,31.02,13601,68.98,19718,99.01,198,0.99,19916
1,VIC,233,Warrnambool Voting Day PPVC,0,0,0,0,0,0,0,0,0
1,VIC,233,Warrnambool West,222,32.65,458,67.35,680,98.69,9,1.31,689
1,VIC,220,Watsonia,688,51.42,650,48.58,1338,98.6,19,1.4,1357
1,VIC,220,Watsonia Central,677,57.28,505,42.72,1182,98.25,21,1.75,1203
1,VIC,220,Watsonia North,845,49.59,859,50.41,1704,98.73,22,1.27,1726
1,VIC,226,Wattle Glen,461,54.95,378,45.05,839,99.06,8,0.94,847
1,VIC,205,Wattle Park,797,58.13,574,41.87,1371,98.49,21,1.51,1392
1,VIC,233,Waubra,37,25.52,108,74.48,145,98.64,2,1.36,147
1,VIC,224,Wedderburn,160,22.32,557,77.68,717,99.45,4,0.55,721
1,VIC,323,Welshpool,113,27.43,299,72.57,412,97.86,9,2.14,421
1,VIC,198,Wendouree,808,47.45,895,52.55,1703,98.55,25,1.45,1728
1,VIC,198,Wendouree North,325,37.14,550,62.86,875,98.76,11,1.24,886
1,VIC,198,Wendouree West,214,36.9,366,63.1,580,97.64,14,2.36,594
1,VIC,222,Werribee Central,691,45.82,817,54.18,1508,98.69,20,1.31,1528
1,VIC,222,Werribee East,519,41.16,742,58.84,1261,98.44,20,1.56,1281
1,VIC,212,Werribee GELLIBRAND PPVC,485,34.79,909,65.21,1394,99.29,10,0.71,1404
1,VIC,222,Werribee LALOR PPVC,6610,36.66,11419,63.34,18029,99.04,174,0.96,18203
1,VIC,222,Werribee South,142,32.42,296,67.58,438,99.32,3,0.68,441
1,VIC,204,Wesburn,215,31.48,468,68.52,683,98.56,10,1.44,693
1,VIC,218,West End,438,40.97,631,59.03,1069,98.98,11,1.02,1080
1,VIC,321,West Footscray,1189,78.38,328,21.62,1517,99.15,13,0.85,1530
1,VIC,321,West Footscray Central,1073,78.21,299,21.79,1372,99.35,9,0.65,1381
1,VIC,326,West Melton,525,36.61,909,63.39,1434,98.29,25,1.71,1459
1,VIC,218,West Wodonga Victory,521,33.46,1036,66.54,1557,98.67,21,1.33,1578
1,VIC,320,Westgarth,708,87.52,101,12.48,809,99.39,5,0.61,814
1,VIC,222,Westgrove,791,45.05,965,54.95,1756,98.76,22,1.24,1778
1,VIC,326,Westlake,605,37.93,990,62.07,1595,99.32,11,0.68,1606
1,VIC,203,Westmeadows,582,40.17,867,59.83,1449,98.71,19,1.29,1468
1,VIC,203,Westmeadows CALWELL PPVC,5790,36.95,9878,63.05,15668,98.21,285,1.79,15953
1,VIC,234,Westmeadows WILLS PPVC,2541,45.71,3018,54.29,5559,98.67,75,1.33,5634
1,VIC,205,Wheelers Hill,599,43.85,767,56.15,1366,99.13,12,0.87,1378
1,VIC,205,Wheelers Hill Central,583,44.13,738,55.87,1321,98.88,15,1.12,1336
1,VIC,205,Wheelers Hill South,489,38.81,771,61.19,1260,99.13,11,0.87,1271
1,VIC,205,Wheelers Hill West,497,48.16,535,51.84,1032,98.95,11,1.05,1043
1,VIC,200,White Hills,264,39.76,400,60.24,664,99.1,6,0.9,670
1,VIC,200,White Hills South,249,48.35,266,51.65,515,99.04,5,0.96,520
1,VIC,218,Whitfield,76,42.22,104,57.78,180,99.45,1,0.55,181
1,VIC,226,Whittlesea,620,31.71,1335,68.29,1955,98.69,26,1.31,1981
1,VIC,226,Whittlesea Central,168,33.6,332,66.4,500,99.21,4,0.79,504
1,VIC,218,Whorouly,45,21.33,166,78.67,211,99.06,2,0.94,213
1,VIC,233,Willaura,49,24.14,154,75.86,203,99.51,1,0.49,204
1,VIC,212,Williamstown,396,65.02,213,34.98,609,99.19,5,0.81,614
1,VIC,212,Williamstown Bayview,232,71.17,94,28.83,326,99.69,1,0.31,327
1,VIC,212,Williamstown North,1156,66.28,588,33.72,1744,99.09,16,0.91,1760
1,VIC,212,Williamstown South,1346,68.6,616,31.4,1962,99.09,18,0.91,1980
1,VIC,212,Williamstown West,763,56.81,580,43.19,1343,98.6,19,1.4,1362
1,VIC,323,Willowgrove,98,22.12,345,77.88,443,99.55,2,0.45,445
1,VIC,324,Wilmot,542,35.52,984,64.48,1526,98.32,26,1.68,1552
1,VIC,233,Winchelsea,368,35.62,665,64.38,1033,98.76,13,1.24,1046
1,VIC,233,Winchelsea South,67,41.61,94,58.39,161,96.41,6,3.59,167
1,VIC,215,Windsor (Higgins),987,78.02,278,21.98,1265,98.75,16,1.25,1281
1,VIC,322,Windsor (Macnamara),257,82.64,54,17.36,311,99.36,2,0.64,313
1,VIC,218,Wodonga,508,38.25,820,61.75,1328,99.03,13,0.97,1341
1,VIC,218,Wodonga Central,605,36.76,1041,63.24,1646,98.03,33,1.97,1679
1,VIC,218,Wodonga Central PPVC,1805,33.15,3640,66.85,5445,99.09,50,0.91,5495
1,VIC,218,Wodonga PPVC,4264,26.79,11652,73.21,15916,99.08,147,0.92,16063
1,VIC,218,Wodonga South,325,36.43,567,63.57,892,99.78,2,0.22,894
1,VIC,226,Wollert,100,49.02,104,50.98,204,99.51,1,0.49,205
1,VIC,232,Wollert South,549,46.13,641,53.87,1190,98.27,21,1.73,1211
1,VIC,229,Wonga Park,374,43.29,490,56.71,864,98.97,9,1.03,873
1,VIC,323,Wonthaggi,468,42.39,636,57.61,1104,98.4,18,1.6,1122
1,VIC,323,Wonthaggi North,296,39.89,446,60.11,742,98.02,15,1.98,757
1,VIC,323,Wonthaggi PPVC,4289,35.95,7643,64.05,11932,99.08,111,0.92,12043
1,VIC,226,Woodend,1006,57.39,747,42.61,1753,99.21,14,0.79,1767
1,VIC,226,Woodend East,797,71.16,323,28.84,1120,98.94,12,1.06,1132
1,VIC,233,Woodford,137,37.64,227,62.36,364,99.45,2,0.55,366
1,VIC,213,Woodside,104,29.05,254,70.95,358,98.62,5,1.38,363
1,VIC,226,Woodstock,488,53.92,417,46.08,905,99.67,3,0.33,908
1,VIC,200,Woodvale,33,27.27,88,72.73,121,99.18,1,0.82,122
1,VIC,222,Woodville,483,47.96,524,52.04,1007,98.82,12,1.18,1019
1,VIC,233,Woolsthorpe,62,21.23,230,78.77,292,99.32,2,0.68,294
1,VIC,224,Woomelang,28,17.07,136,82.93,164,98.2,3,1.8,167
1,VIC,218,Wooragee,133,47.84,145,52.16,278,98.23,5,1.77,283
1,VIC,204,Woori Yallock,412,34.59,779,65.41,1191,98.67,16,1.33,1207
1,VIC,224,Woorinen,29,17.9,133,82.1,162,100,0,0,162
1,VIC,324,Wunghnu,51,13.6,324,86.4,375,99.21,3,0.79,378
1,VIC,224,Wycheproof,108,23.18,358,76.82,466,99.57,2,0.43,468
1,VIC,222,Wyndham South,686,54.32,577,45.68,1263,98.75,16,1.25,1279
1,VIC,222,Wyndham Vale,884,53.51,768,46.49,1652,99.34,11,0.66,1663
1,VIC,222,Wyndham Vale South,882,58.88,616,41.12,1498,98.75,19,1.25,1517
1,VIC,218,Yackandandah,466,51.89,432,48.11,898,99.01,9,0.99,907
1,VIC,220,Yallambie,882,53.71,760,46.29,1642,99.33,11,0.67,1653
1,VIC,213,Yallourn North,101,23.22,334,76.78,435,98.42,7,1.58,442
1,VIC,226,Yan Yean,85,36.64,147,63.36,232,99.15,2,0.85,234
1,VIC,323,Yanakie,86,45.5,103,54.5,189,97.93,4,2.07,193
1,VIC,198,Yandoit,110,54.46,92,45.54,202,100,0,0,202
1,VIC,218,Yarck,83,29.64,197,70.36,280,100,0,0,280
1,VIC,204,Yarra Glen,434,36.38,759,63.62,1193,98.84,14,1.16,1207
1,VIC,204,Yarra Junction,408,35.88,729,64.12,1137,99.48,6,0.52,1143
1,VIC,323,Yarragon,277,35.38,506,64.62,783,99.11,7,0.89,790
1,VIC,213,Yarram,327,27.88,846,72.12,1173,98.57,17,1.43,1190
1,VIC,226,Yarrambat,299,35.34,547,64.66,846,99.65,3,0.35,849
1,VIC,321,Yarraville (Fraser),797,76.34,247,23.66,1044,99.05,10,0.95,1054
1,VIC,212,Yarraville (Gellibrand),271,74.04,95,25.96,366,98.92,4,1.08,370
1,VIC,321,Yarraville Central (Fraser),883,82.06,193,17.94,1076,99.35,7,0.65,1083
1,VIC,212,Yarraville Central (Gellibrand),290,77.13,86,22.87,376,99.73,1,0.27,377
1,VIC,212,Yarraville South,906,70.4,381,29.6,1287,99.08,12,0.92,1299
1,VIC,324,Yarrawonga,243,29.35,585,70.65,828,99.04,8,0.96,836
1,VIC,324,Yarrawonga PPVC,1174,19.51,4842,80.49,6016,99.08,56,0.92,6072
1,VIC,324,Yarroweyah,49,15.22,273,84.78,322,100,0,0,322
1,VIC,218,Yarrunga,212,37,361,63,573,99.48,3,0.52,576
1,VIC,218,Yea,282,32.79,578,67.21,860,99.19,7,0.81,867
1,VIC,213,Yinnar,267,36.73,460,63.27,727,99.18,6,0.82,733
